border_size=1
usage=map

Ss          , Ss          , Ss          , Ss          , Ss          , Ss          , Ss          , Ss          , Gs^Fp       , Gs^Fp       , Gs^Fp       , Gs^Fp       , Gs^Fp       , Gs^Fp       , Ss          , Ss          , Ss          , Ss          , Ss          , Ss          , Gs          , Gs          , Gs          , Gs          , Gs          , Ds          , Ss          , Ss          
Ss          , Gs^Fp       , Gs^Fp       , Ss          , Gs^Fp       , Hh          , Hh          , Ss          , Ss          , Gs^Fp       , Gs^Fp       , Gs^Fp       , Ss          , Ss          , Ss^Uf       , Ss          , Ss          , Ss          , Ss          , Ds          , Gs          , Gs          , Ds          , Ds          , Ds          , Ds          , Ss          , Ss          
Ss          , Gs^Fp       , Gs^Fp       , Gs^Fp       , Gs^Fp       , Hh          , Hh          , Ss          , Ss          , Ss          , Ss          , Ss          , Ss          , Ss^Uf       , Ss^Uf       , Ss          , Ss          , Ss          , Ds          , Ds          , Gs          , Gs          , Ss          , Ss          , Ss          , Ss          , Ss          , Ss          
Ss          , Ss          , Ss          , Gs^Fp       , Gs^Fp       , Hh          , Ss          , Ss          , Ss          , Ss          , Ss          , Ss          , Ss          , Ss^Uf       , Ss          , Ss          , Ss          , Ss          , Gs          , Gs          , Ds          , Ds          , Ss          , Gs          , Ss          , Ss          , Ss          , Ss          
Ss          , Ss          , Ss          , Gs^Fp       , Ss^Uf       , Gs^Fp       , Ss          , Ss          , Ds^Dr       , Ss          , Ss          , Ss          , Gs^Fp       , Ss          , Ss          , Ss          , Ss          , Ds          , Gs          , 1 Gs        , Gs          , Ds^Dr       , Ss          , Ss          , Ss          , Ss          , Ss^Uf       , Ss^Uf       
Ss          , Ss          , Ss^Uf       , Ss          , Ss^Uf       , Ss          , Ss          , Ds          , Ss          , Ds          , Ss          , Ss          , Gs^Fp       , Gs^Fp       , Gs^Fp       , Ss          , Ss          , Ds          , Ds          , Gs          , Ds          , Ss          , Ss          , Ss          , Ss          , Ss^Uf       , Ss          , Ss^Uf       
Ss          , Ss          , Ss          , Ss^Uf       , Ss^Uf       , Ss^Uf       , Ss          , Ds          , Ss          , Ss          , Ss          , Ss          , Gs^Fp       , Ss          , Gs^Fp       , Ss          , Ss          , Ds          , Ds          , Ds          , Ss          , Ss          , Ss          , Ss          , Ss          , Ss          , Ss          , Ss^Uf       
Ss          , Ss          , Ss          , Ss          , Ss          , Ss          , Ss^Uf       , Ss          , Ss          , Ss          , Ss          , Ss          , Ss          , Gs^Fp       , Ss          , Ss          , Ss          , Ds^Dr       , Ds          , Ds          , Ss          , Ss          , Ss          , Ss          , Ss          , Ss          , Re          , Re          
Gs^Fp       , Ss          , Hh          , Ss          , Ss          , Ss          , Ss          , Ss          , Ss          , Ss          , Ss          , Ss          , Gs^Fp       , Ss          , Ss          , Ss          , Ss          , Ss          , Ss          , Ss          , Ss          , Ss          , Ss          , Ss          , Gs^Fp       , Ss          , Gs^Fp       , Re          
Gs^Fp       , Gs^Fp       , Gs^Fp       , Hh          , Ss          , Ss          , Ds          , Ss          , Ss          , Ss          , Gs          , Ss          , Ss          , Ss          , Ss          , Ss          , Ss          , Ss          , Ss          , Ss          , Ss          , Ss          , Ss          , Gs^Fp       , Gs^Fp       , Gs^Fp       , Re          , Re          
Gs^Fp       , Gs^Fp       , Gs^Fp       , Ss          , Ss          , Ss          , Ds          , Gs          , Ss          , Gs          , Hh          , Gs          , Gs          , Ss          , Ss          , Ss          , Ss          , Ss          , Ss          , Ss          , Ss          , Ss          , Ss          , Gs^Fp       , Gs^Fp       , Gs^Fp       , Gs^Fp       , Re          
Ss          , Gs^Fp       , Ss          , Ss          , Ss          , Ss          , Ds          , Ds^Dr       , Ss          , Hh          , Hh          , Hh          , Ss          , Ss          , Ds          , Ds^Dr       , Ds          , Ss          , Ss          , Ss          , Ss          , Ss          , Ss          , Gs^Fp       , Ss          , Ss          , Ss          , Ss          
Ss          , Ss          , Ss          , Ss          , Ss          , Ss          , Ss          , Ss          , Ss          , Ss          , Hh          , Ss          , Ss          , Ss          , Ds          , Gs          , Ss          , Ss          , Ss          , Ss          , Ss          , Ss          , Ss          , Ss          , Ss          , Ss          , Ss          , Ss          
Ss          , Ss          , Ss          , Ss          , Ss          , Ss          , Ss          , Ss          , Ss          , Ss          , Hh          , Ss          , Ss          , Ss          , Ds          , Ss          , Ss          , Ss          , Ss          , Ss          , Ss          , Ss          , Ss          , Ss          , Gs^Fp       , Ss          , Ss          , Ss          
Ss          , Ss          , Ss          , Ss          , Ss          , Ss          , Gs          , Ss          , Ss          , Ds          , Gs          , Hh          , Ss          , Ss          , Ss          , Ss          , Ss          , Ss          , Ss          , Ss          , Gs          , Ss          , Gs^Fp       , Gs^Fp       , Gs^Fp       , Ss          , Ss          , Ss          
Ss          , Ss          , Ss          , Ss          , Ss          , Gs          , Gs          , Ss          , Ss          , Ds          , Ss          , Ds          , Ss          , Ss          , Ss^Uf       , Ss          , Ss          , Ss          , Ss          , Ss          , Ss          , Ss          , Gs^Fp       , Gs^Fp       , Ss          , Ss          , Ss          , Ss          
Ss          , Ss          , Ss          , Ss          , Ss          , Gs^Fp       , Gs^Fp       , Gs^Fp       , Ss^Fp       , Ss          , Ss          , Ss          , Ss          , Ss^Uf       , Ss^Uf       , Ss^Uf       , Ss          , Ss          , Ss          , Ss          , Ss          , Ss          , Ss          , Ss          , Ss          , Ss          , Ss          , Ss          
Ss          , Ss          , Ss          , Ss          , Ss          , Ss          , Gs^Fp       , Gs^Fp       , Ss^Fp       , Ss          , Ss          , Ss          , Ss          , Ss          , Ss          , Ss          , Ss          , Ss          , Ss          , Ss          , Ss          , Ss          , Ss          , Ss          , Ss          , Ss          , Ss          , Ss          
Ss          , Ss          , Ss          , Ss          , Ss          , Ss          , Ss          , Ss          , Ss          , Ss          , Ss          , Ss          , Ss          , Ss          , Ss          , Gs          , Gs          , Ss          , Ss          , Gs          , Gs          , Gs          , Gs          , Ss          , Ss          , Ss          , Ss          , Ss          
Ss          , Ss          , Ss          , Ss          , Ss          , Ss          , Ss          , Ss          , Ss          , Ss          , Ss          , Ss          , Ss          , Ss          , Gs          , Gs          , Ss          , Ss          , Ss          , Gs          , Gs          , Gs          , Ss          , Ss          , Ss          , Ss          , Ss          , Ss          
Ss          , Ss          , Ss          , Ss          , Ss          , Ss          , Ss          , Ss          , Ss          , Ss          , Ss          , Ss          , Ss          , Ss          , Ss          , Ss          , Gs^Fp       , Ss          , Ss          , Ss          , Ss          , Ss          , Ss          , Ss          , Ss          , Ss          , Gs^Fp       , Gs^Fp       
Ss          , Gs          , Gs          , Ss          , Gs          , Ss          , Ss          , Ss          , Ss          , Ss          , Ss^Fp       , Ss          , Ss          , Ss          , Ss          , Gs^Fp       , Gs^Fp       , Gs^Fp       , Ss          , Ss          , Ss          , Ss          , Ss          , Ss          , Hh          , Hh          , Gs^Fp       , Gs^Fp       
Gs          , Hh          , Hh          , Hh          , Gs          , Ss          , Ss          , Ss          , Ss          , Ss^Fp       , Ss^Fp       , Ss          , Hh          , Ss          , Ss          , Ss          , Ss          , Ss          , Re          , Ss          , Ss          , Ss          , Ss          , Hh          , Hh          , Hh          , Ss          , Gs^Fp       
Ss          , Hh          , Gs          , Hh          , Gs^Fp       , Gs^Fp       , Gs^Fp       , Ss          , Ss          , Ss^Fp       , Gs^Fp       , Hh          , Hh          , Ss          , Gs^Fp       , Ss          , Ss          , Ss          , Re          , Ds          , Ds          , Ss          , Ss          , Hh          , Ss          , Hh          , Ss          , Gs^Fp       
Ss          , Gs          , Ss          , Gs          , Gs^Fp       , Gs^Fp       , Gs^Fp       , Ss          , Ss          , Gs          , Ds          , Hh          , Hh          , Gs^Fp       , Gs^Fp       , Ss          , Ss          , Ds          , Re          , Re          , Ds^Dr       , Ss          , Ss          , Ss          , Ss          , Ss          , Ss          , Ss          
Ss          , Ss          , Ss          , Ss          , Ss          , Gs^Fp       , Ss^Fp       , Ss          , Ss          , Ds          , Ss          , Ss          , Ss          , Ss^Fp       , Gs^Fp       , Ss          , Ss          , Ds          , Gs^Fp       , Ds          , Ss          , Ss          , Gs^Fp       , Gs^Fp       , Gs^Fp       , Ss          , Re          , Ss          
Ss          , Ss          , Ss          , Ss          , Ss          , Ss^Fp       , Ss          , Ss          , Ss          , Ss          , Ss          , Ss          , Ss          , Ss          , Ss          , Ss          , Ss          , Ss          , Ss          , Ss          , Ss          , Gs^Fp       , Gs^Fp       , Gs^Fp       , Re          , Re          , Re          , Re          
Ss          , Ss          , Ss          , Ss          , Ds          , Ss          , Ss          , Ss          , Ss          , Ss          , Ss          , Ss          , Ss          , Ss          , Ss          , Ss          , Ss          , Ss          , Gs^Fp       , Ss          , Hh          , Gs^Fp       , Ss          , Re          , Re          , Re          , Re          , Re          
Ss          , Ss          , Ss          , Ds          , Gs          , Gs          , Ss          , Ss          , Ss          , Ss          , Ss          , Ss          , Ss          , Ss          , Ss          , Gs^Fp       , Gs^Fp       , Gs^Fp       , Gs^Fp       , Ss          , Hh          , Hh          , Hh          , Ss          , Ss          , Ss          , Ss          , Ss          
Ss          , Ss          , Ss          , Ss          , Ss          , Gs          , Ds          , Ds          , Ds          , Ss          , Ss          , Ss          , Ss          , Ss          , Ss          , Ss          , Ss          , Gs^Fp       , Ss          , Gs^Fp       , Ss          , Hh          , Ss          , Ss          , Ss          , Ss          , Ss          , Ss          
