border_size=1
usage=map

Gs          , Gs          , Gs          , Gs          , Gs          , Gs          , Gs          , Gs          , Gs          , Gs          , Gs          , Gs          , Gs          , Gs          , Gs          , Gs          , Gs          , Gs          , Gs          , Gs          , Gs          , Gs          , Gs          , Gs          , Gs          , Gs          , Gs          , Gs          , Gs          , Gs          , Ww          , Ww          , Wo          , Wo          , Wo          , Wo          , Wo          , Wo          , Wo          , Wo          , Ww          , Ww          
Gs          , Gs          , Gs          , Gs          , Gs          , Gs          , Gs          , Gs          , Gs          , Gs          , Gs          , Gs          , Gs          , Gs          , Hh          , Hh          , Gs          , Gs          , Gs^Ft       , Gs^Ft       , Gs          , Gs          , Gs          , Gs          , Gs^Ft       , Gs          , Gs^Ft       , Gs          , Gs          , Wwf         , Ww          , Wo          , Wo          , Wo          , Ww          , Wo          , Ww          , Wo          , Ww          , Ww          , Wwf         , Wwf         
Gs          , Gs          , Gs          , Gs          , Gs          , Gs          , Gs          , Gs          , Gs          , Gs          , Gs          , Gs          , Gs          , Gs          , Hh          , Hh          , Gs          , Gs^Ft       , Gs^Ft       , Gs^Ft       , Gs          , Gs^Ft       , Gs          , Gs          , Gs          , Gs^Ft       , Gs^Ft       , Gs^Ft       , Ww          , Ww          , Wo          , Wo          , Ww          , Ww          , Ds          , Ww          , Gs          , Wwf         , Gs^Ft       , Wwf         , Gs          , Gs          
Gs          , Gs          , Gs          , Gs          , Gs          , Gs          , Gs          , Gs          , Gs          , Gs          , Gs          , Gs          , Gs          , Gs          , Gs          , Gs          , Ww          , Wwf         , Ww          , Ww          , Ww          , Gs          , Gs          , Gs          , Ds          , Gs^Ft       , Ww          , Ww          , Wo          , Ww          , Ww          , Ww          , Gs^Ft       , Gs          , Gs          , Gs          , Gs          , Gs^Ft       , Gs^Ft       , Gs^Ft       , Gs          , Gs          
Gs          , Gs          , Gs          , Gs          , Gs          , Gs          , Gs          , Gs          , Gs          , Gs          , Gs          , Gs          , Gs          , Gs          , Ww          , Ww          , Wo          , Wo          , Wo          , Wo          , Wo          , Ww          , Ww          , Wwf         , Ww          , Ww          , Wo          , Wo          , Wo          , Ww          , Ds          , Gs^Ft       , Gs^Ft       , Gs^Ft       , Gs          , Gs          , Gs          , Gs          , Gs          , Gs          , Gs          , Gs          
Gs          , Gs          , Gs          , Gs          , Gs          , Gs          , Gs^Ft       , Gs          , Gs^Ft       , Gs^Ft       , Gs          , Gs          , Ds          , Wwf         , Wo          , Wo          , Ww          , Ww          , Ww          , Ww          , Ww          , Wo          , Wo          , Wo          , Wo          , Wo          , Ww          , Ww          , Ww          , Wwf         , Gs          , Gs          , Gs^Ft       , Gs          , Gs          , Gs          , Gs          , Gs          , Hh          , Gs          , Gs          , Gs          
Gs          , Gs          , Gs          , Gs          , Gs          , Gs          , Gs^Ft       , Gs^Ft       , Gs^Ft       , Gs          , Ww          , Ww          , Ww          , Wo          , Ww          , Wwf         , Gs          , Gs          , Gs          , Gs          , Gs^Ft       , Ww          , Ww          , Ww          , Wwf         , Wwf         , Gs          , Gs          , Gs          , Gs          , Gs          , Gs          , Gs          , Gs          , Gs          , Gs          , Hh          , Hh          , Hh          , Hh          , Gs          , Gs          
Gs          , Gs          , Gs          , Gs          , Gs          , Gs          , Gs          , Gs^Ft       , Ww          , Ww          , Wo          , Wo          , Wo          , Wo          , Wwf         , Gs          , Gs          , Gs          , Gs          , Gs^Ft       , Gs          , Gs^Ft       , Gs          , Gs          , Gs          , Gs          , Gs          , Gs          , Gs          , Gs          , Hh          , Hh          , Hh          , Gs          , Gs          , Hh          , Hh          , Hh          , Hh          , Hh          , Gs          , Gs          
Gs          , Gs          , Gs          , Gs          , Gs          , Gs          , Gs          , Wwf         , Ww          , Wo          , Wo          , Wo          , Ww          , Ww          , Gs          , Gs          , Gs          , Re          , Re          , Re          , Re^Vct      , Gs^Ft       , Gs          , Gs          , Gs          , Gs          , Gs          , Gs          , Gs          , Re^Vct      , Hh          , Hh          , Gs          , Gs          , Gs          , Hh          , Gs          , Gs          , Gs          , Gs          , Gs          , Gs          
Gs          , Gs          , Gs          , Gs          , Gs^Ft       , Gs          , Gs          , Ww          , Wo          , Wo          , Ww          , Ww          , Gs          , Gs          , Gs^Ft       , Gs^Ft       , Re          , Re          , Ce          , Re          , Re          , Gs          , Gs          , Gs          , Gs          , Gs          , Gs          , Gs          , Gs          , Hh          , Hh          , Hh          , Gs          , Gs          , Gs          , Gs          , Gs          , Gs          , Gs          , Gs          , Gs          , Gs          
Gs          , Gs          , Gs^Ft       , Gs          , Gs^Ft       , Gs          , Ds          , Ww          , Wo          , Ww          , Ds          , Ds          , Gs^Ft       , Gs          , Gs^Ft       , Gs          , Re          , Ce          , 1 Ke        , Ce          , Re          , Re          , Re          , Gs          , Gs          , Gs          , Hh          , Gs          , Gs          , Gs          , Gs          , Hh          , Gs          , Gs          , Gs          , Gs          , Gs          , Gs          , Gs          , Gs          , Gs          , Gs          
Gs          , Gs          , Hh          , Hh          , Gs^Ft       , Gs          , Ww          , Ww          , Wo          , Ww          , Ds          , Ds          , Gs^Ft       , Gs          , Gs          , Gs          , Re          , Re          , Re          , Ce          , Re          , Re^Vct      , Gs          , Gs          , Gs          , Hh          , Hh          , Gs          , Gs          , Gs          , Gs          , Gs          , Gs          , Gs          , Gs          , Gs          , Gs          , Gs          , Gs          , Gs          , Gs          , Gs          
Ww          , Gs          , Gs          , Hh          , Hh          , Gs^Ft       , Ww          , Wo          , Wo          , Ww          , Ds          , Gs^Ft       , Gs^Ft       , Gs^Ft       , Gs^Ft       , Gs          , Gs          , Re^Vct      , Re          , Re          , Re          , Re          , Re          , Gs          , Hh          , Hh          , Hh          , Gs          , Hh          , Gs          , Hh          , Gs          , Gs          , Gs          , Gs          , Gs          , Gs          , Gs          , Gs          , Gs          , Gs          , Gs          
Wo          , Ww          , Wwf         , Gs          , Hh          , Hh          , Ww          , Wo          , Wo          , Ww          , Ds          , Gs          , Gs          , Gs^Ft       , Gs          , Gs          , Gs          , Gs          , Re          , Re^Vct      , Re          , 2 Gs        , Gs          , Gs          , Hh          , Dd          , Dd          , Dd          , Dd          , Hh          , Gs          , Hh          , Gs          , Gs          , Gs          , Gs          , Gs          , Re^Vct      , Gs          , Gs          , Gs          , Gs          
Wo          , Wo          , Ww          , Wwf         , Ww          , Ww          , Wo          , Wo          , Wo          , Ww          , Gs          , Gs          , Gs          , Re^Vct      , Gs          , Gs          , Gs          , Gs          , Gs          , Gs          , Gs          , Gs          , Hh          , Gs          , Gs          , Gs^Ft       , Gs          , Dd          , Gs          , Gs          , Gs          , Gs          , Gs          , Gs          , Gs          , Gs          , Gs          , Gs          , Gs          , Gs          , Gs          , Gs          
Wo          , Wo          , Wo          , Wo          , Wo          , Wo          , Ww          , Wo          , Ww          , Wwf         , Gs          , Gs          , Hh          , Gs          , Gs          , Gs          , Gs          , Gs          , Gs          , Gs          , Gs          , Hh          , Ww          , Hh          , Gs          , Gs          , Gs          , Gs          , Gs          , Gs          , Gs^Ft       , Gs          , Gs          , Gs          , Gs          , Gs          , Gs          , Gs          , Gs          , Gs          , Gs          , Gs          
Ww          , Ww          , Ww          , Wo          , Ww          , Ww          , Ds          , Ww          , Ds          , Gs          , Hh          , Hh          , Hh          , Gs          , Gs          , Gs          , Gs^Ft       , Gs^Ft       , Gs          , Gs          , Hh          , Hh          , Wo          , Wo          , Ww          , Re^Vct      , Gs          , Gs          , Gs          , Gs^Ft       , Gs^Ft       , Gs^Ft       , Gs          , Gs          , Gs          , Gs          , Gs          , Gs          , Gs          , Gs          , Dd          , Gs          
Gs          , Gs          , Gs          , Ww          , Gs          , Ds          , Gs^Ft       , Gs^Ft       , Gs^Ft       , Gs          , Gs          , Hh          , Hh          , Gs          , Gs          , Gs          , Gs^Ft       , Gs^Ft       , Gs          , Gs          , Ww          , Wo          , Wo          , Wo          , Wo          , Gs          , Gs          , Gs          , Gs          , Gs^Ft       , Gs          , Gs          , Gs          , Gs          , Gs          , Gs          , Gs          , Gs          , Gs          , Dd          , Dd          , Dd          
Gs^Ft       , Gs^Ft       , Gs^Ft       , Gs^Ft       , Gs          , Gs^Ft       , Gs^Ft       , Gs^Ft       , Gs^Ft       , Gs          , Gs          , Gs          , Hh          , Gs          , Gs          , Gs          , Gs          , Gs          , Gs          , Gs          , Ww          , Wo          , Wo          , Wo          , Wo          , Ww          , Gs          , Gs          , Gs          , Gs          , Gs          , Gs          , Gs          , Gs          , Gs          , Gs          , Gs          , Gs          , Gs          , Gs          , Gs          , Dd          
Gs          , Gs^Ft       , Gs          , Gs          , Gs          , Gs          , Gs          , Gs          , Gs          , Gs          , Gs          , Gs          , Gs          , Gs          , Gs          , Gs          , Gs          , Gs          , Gs          , Gs          , Gs^Ft       , Wo          , Wo          , Wo          , Ww          , Ww          , Gs          , Gs          , Gs          , Gs          , Gs          , Gs          , Gs          , Gs          , Gs          , Gs          , Gs          , Gs          , Gs          , Gs          , Gs          , Gs          
Gs          , Gs          , Gs          , Gs          , Gs          , Gs          , Gs          , Gs          , Gs          , Gs          , Re^Vct      , Gs          , Gs          , Gs          , Gs          , Gs          , Gs          , Gs          , Gs          , Gs^Ft       , Gs^Ft       , Gs          , Ww          , Ww          , Gs          , Gs          , Re^Vct      , Gs          , Gs          , Gs          , Dd          , Hh          , Hh          , Hh          , Gs          , Gs          , Gs          , Gs          , Gs          , Gs          , Gs          , Gs          
Gs          , Gs          , Gs          , Gs          , Gs          , Gs          , Gs          , Gs          , Gs          , Gs          , Gs          , Gs          , Gs          , Gs          , Gs          , Gs          , Gs          , Gs          , Gs          , Gs^Ft       , Gs^Ft       , Gs          , Gs          , Gs          , Gs          , Gs          , Gs          , Gs          , Dd          , Dd          , Dd          , Hh          , Hh          , Gs          , Gs          , Gs          , Gs          , Gs          , Gs          , Gs          , Gs          , Gs          
Gs          , Gs          , Gs          , Gs          , Gs          , Gs          , Gs          , Gs          , Hh          , Gs          , Gs          , Gs          , Gs          , Gs          , Gs          , Gs          , Gs          , Gs          , Gs          , Gs          , Gs          , Gs          , Gs          , Gs          , Gs          , Gs          , Gs          , Gs          , Gs          , Dd          , Dd          , Hh          , Gs          , Gs          , Gs          , Gs          , Gs          , Gs          , Gs          , Gs          , Gs          , Gs          
Gs          , Gs          , Gs          , Gs          , Gs          , Gs          , Gs          , Gs          , Hh          , Hh          , Hh          , Gs          , Gs          , Gs          , Gs          , Gs          , Re^Vct      , Gs          , Gs          , Gs          , Gs          , Gs          , Gs          , Re^Vct      , Gs          , Gs          , Gs          , Gs          , Re^Vct      , Gs          , Gs          , Gs          , Gs          , Gs          , Gs          , Re^Vct      , Gs          , Gs          , Gs          , Gs          , Dd          , Dd          
Gs          , Gs          , Gs          , Gs          , Gs          , Gs          , Gs          , Gs          , Hh          , Hh          , Hh          , Gs          , Gs          , Gs          , Gs          , Gs          , Gs          , Gs          , Gs          , Gs          , Gs          , Gs          , Gs          , Gs          , Gs          , Gs          , Gs          , Gs          , Gs          , Gs          , Gs          , Gs          , Gs          , Gs          , Gs          , Gs          , Gs          , Gs          , Gs          , Gs          , Dd          , Dd          
Gs          , Gs          , Gs          , Gs          , Gs          , Gs          , Gs          , Gs          , Gs          , Hh          , Gs          , Gs          , Gs          , Gs          , Gs          , Gs          , Gs          , Gs          , Gs          , Gs          , Re^Vct      , Gs          , Gs          , Gs          , Gs          , Gs          , Gs          , Gs          , Gs          , Gs          , Gs          , Gs          , Gs          , Gs          , Gs          , Gs          , Gs          , Gs          , Dd          , Dd          , Gs          , Dd          
Gs          , Gs          , Gs          , Gs          , Hh          , Gs          , Gs          , Gs          , Gs          , Gs          , Gs          , Gs          , Gs          , Gs          , Gs          , Dd          , Dd          , Gs          , Gs          , Gs          , Gs          , Gs          , Ce          , Ce          , Ke          , Ce          , Gs          , Gs          , Gs          , Re^Vct      , Gs          , Gs          , Gs          , Gs          , Gs          , Gs          , Gs          , Gs          , Gs          , Gs          , Gs          , Dd          
Gs          , Hh          , Hh          , Hh          , Dd          , Gs          , Gs          , Gs          , Gs          , Gs          , Gs          , Gs          , Gs          , Gs          , Gs          , Dd          , Dd          , Gs          , Dd          , Gs          , Re^Vct      , Gs          , Gs          , Ce          , Ce          , Gs          , Gs          , Gs          , Gs          , Gs          , Gs          , Gs          , Gs          , Gs          , Dd          , Gs          , Dd          , Dd          , Gs          , Gs          , Dd          , Dd          
Gs          , Hh          , Gs          , Hh          , Dd          , Dd          , Dd          , Dd          , Gs          , Gs          , Gs          , Gs          , Gs          , Gs          , Hh          , Hh          , Hh          , Dd          , Dd          , Gs          , Gs          , Gs          , Gs          , Gs          , Gs          , Gs          , Gs          , Re^Vct      , Gs          , Gs          , Gs          , Hh          , Hh          , Dd          , Dd          , Dd          , Gs          , Gs          , Gs          , Gs          , Gs          , Dd          
Gs          , Gs          , Gs          , Gs          , Gs          , Gs          , Gs          , Gs          , Gs          , Gs          , Gs          , Gs          , Gs          , Gs          , Hh          , Hh          , Hh          , Dd          , Gs          , Gs          , Gs          , Gs          , Re^Vct      , Gs          , Gs          , Gs          , Re^Vct      , Gs          , Gs          , Gs          , Hh          , Hh          , Hh          , Dd          , Dd          , Dd          , Gs          , Gs          , Dd          , Dd          , Dd          , Dd          
Dd          , Dd          , Gs          , Gs          , Gs          , Gs          , Gs          , Gs          , Gs          , Gs          , Gs          , Gs          , Gs          , Gs          , Gs          , Hh          , Hh          , Hh          , Gs          , Gs          , Gs          , Gs          , Gs          , Gs          , Gs          , Gs          , Gs          , Gs          , Gs          , Gs          , Gs          , Hh          , Gs          , Dd          , Dd          , Gs          , Gs          , Gs          , Dd          , Dd          , Gs          , Dd          
Dd          , Dd          , Dd          , Gs          , Gs          , Gs          , Gs          , Gs          , Gs          , Gs          , Gs          , Gs          , Gs          , Gs          , Gs          , Gs          , Gs          , Gs          , Gs          , Gs          , Dd          , Gs          , Gs          , Gs          , Gs          , Gs          , Gs          , Gs          , Dd          , Gs          , Gs          , Gs          , Gs          , Gs          , Gs          , Dd          , Dd          , Gs          , Dd          , Dd          , Gs          , Gs          
Dd          , Dd          , Dd          , Gs          , Gs          , Gs          , Gs          , Gs          , Dd          , Gs          , Gs          , Gs          , Dd          , Gs          , Gs          , Gs          , Gs          , Gs          , Gs          , Gs          , Dd          , Gs          , Dd          , Gs          , Gs          , Gs          , Dd          , Dd          , Dd          , Gs          , Dd          , Gs          , Gs          , Dd          , Dd          , Dd          , Dd          , Gs          , Gs          , Dd          , Dd          , Dd          
Gs          , Dd          , Dd          , Dd          , Dd          , Gs          , Gs          , Dd          , Dd          , Dd          , Gs          , Dd          , Dd          , Dd          , Dd          , Dd          , Gs          , Gs          , Gs          , Gs          , Dd          , Dd          , Dd          , Dd          , Gs          , Dd          , Dd          , Dd          , Gs          , Gs          , Dd          , Dd          , Gs          , Dd          , Dd          , Dd          , Dd          , Dd          , Dd          , Dd          , Dd          , Dd          
