border_size=1
usage=map

Hh          , Hh          , Mm          , Mm          , Mm          , Mm          , Mm^Xm       , Mm^Xm       , Xu          , Xu          , Xu          , Xu          , Xu          , Xu          , Xu          , Xu          , Xu          , Xu          , Xu          , Xu          , Xu          , Xu          , Xu          , Xu          , Xu          , Xu          , Xu          , Xu          , Xu          , Xu          
Hh          , Mm          , Mm          , Mm          , Mm          , Mm^Xm       , Mm^Xm       , Xu          , Xu          , Qxu         , Uu          , Qxu         , Xu          , Xu          , Xu          , Xu          , Xu          , Xu          , Xu          , Xu          , Xu          , Xu          , Xu          , Xu          , Qxu         , Xu          , Xu          , Xu          , Xu          , Xu          
Mm          , Mm          , Mm          , Mm          , Mm^Xm       , Mm^Xm       , Xu          , Xu          , Xu          , Qxu         , Qxu         , Uu          , Qxu         , Xu          , Qxu         , Xu          , Xu          , Xu          , Xu          , Xu          , Xu          , Xu          , Uu          , Qxu         , Xu          , Xu          , Xu          , Xu          , Xu          , Xu          
Hh          , Mm          , Mm^Xm       , Mm^Xm       , Xu          , Xu          , Xu          , Xu          , Qxu         , Qxu         , Xu          , Xu          , Xu          , Uh          , Qxu         , Xu          , Xu          , Xu          , Xu          , Xu          , Uh          , Uu          , Rr          , Uu^Vud      , Uu          , Xu          , Xu          , Xu          , Xu          , Xu          
Hh          , Mm          , Mm^Xm       , Mm^Xm       , Mm^Xm       , Xu          , Xu          , Qxu         , Xu          , Uh          , Qxu         , Uh          , Xu          , Xu          , Uu          , Qxu         , Xu          , Xu          , Uh          , Xu          , Uh          , Rr          , Cud         , Rr          , Uh          , Xu          , Xu          , Xu          , Xu          , Xu          
Hh          , Mm          , Mm          , Mm^Xm       , Mm^Xm       , Xu          , Qxu         , Uu          , Xu          , Xu          , Uh          , Uh          , Qxu         , Xu          , Xu          , Xu          , Xu          , Xu          , Uu          , Uu          , Rr          , Rr          , Rr          , Rr          , Uh          , Qxu         , Xu          , Xu          , Xu          , Xu          
Mm          , Mm          , Mm^Xm       , Mm^Xm       , Xu          , Xu          , Xu          , Xu          , Xu          , Xu          , Uu          , Xu          , Xu          , Xu          , Xu          , Qxu         , Uh          , Uh          , Rr          , Rr          , Uu          , Uu          , Uu          , Uu^Vud      , Uh          , Xu          , Xu          , Xu          , Xu          , Xu          
Mm          , Mm^Xm       , Mm^Xm       , Mm^Xm       , Xu          , Xu          , Xu          , Xu          , Uh          , Uh          , Rr          , Uu^Vud      , Uu          , Uh          , Uu          , Uu          , Rr          , Rr          , Uu          , Uh          , Xu          , Xu          , Xu          , Xu          , Qxu         , Uh          , Uh          , Xu          , Xu          , Xu          
Mm^Xm       , Mm^Xm       , Xu          , Xu          , Uh          , Xu          , Xu          , Qxu         , Uh          , Rr          , Cud         , Rr          , Uu          , Uh          , Rr          , Rr          , Uu^Uf       , Uu^Uf       , Xu          , Qxu         , Qxu         , Qxu         , Qxu         , Xu          , Qxu         , Xu          , Uh          , Xu          , Xu          , Xu          
Mm^Xm       , Mm^Xm       , Xu          , Qxu         , Uh          , Xu          , Uh          , Xu          , Rr          , Rr          , Rr          , Rr          , Rr          , Rr          , Uu          , Uu          , Xu          , Xu          , Qxu         , Qxu         , Uu          , Uu          , Uu          , Qxu         , Qxu         , Xu          , Uu          , Uh          , Xu          , Xu          
Mm^Xm       , Xu          , Uh          , Uh          , Qxu         , Uu          , Rr          , Rr          , Rr          , Uu^Vud      , Uu          , Uu          , Uu          , Rr          , Rr          , Uu          , Uu          , Uu          , Uu          , Uu          , Cud         , Cud         , Cud         , Uu          , Qxu         , Qxu         , Uh          , Uh          , Xu          , Xu          
Mm^Xm       , Xu          , Xu          , Uh          , Uu          , Rr          , Uh          , Uu          , Uh          , Uh          , Xu          , Qxu         , Xu          , Uu          , Uu          , Rr          , Rr          , Uu^Vud      , Uu          , Uu          , Cud         , 1 Kud       , Cud         , Uu          , Qxu         , Xu          , Xu          , Xu          , Xu          , Xu          
Mm^Xm       , Mm^Xm       , Mm^Xm       , Xu          , Uu          , Rr          , Uu          , Uh          , Uh          , Xu          , Xu          , Xu          , Xu          , Uh          , Uu^Uf       , Uu^Vud      , Rr          , Rr          , Rr          , Rr          , Uu          , Cud         , Uu          , Uu          , Qxu         , Xu          , Uh          , Xu          , Xu          , Xu          
Mm^Xm       , Mm          , Mm^Xm       , Xu          , Xu          , Rr          , Rr          , Uh          , Qxu         , Xu          , Xu          , Xu          , Xu          , Qxu         , Qxu         , Uu^Uf       , Rr          , Rr          , Rr          , Uu          , Uu          , Uu          , Qxu         , Qxu         , Xu          , Qxu         , Uh          , Xu          , Xu          , Xu          
Mm^Xm       , Mm          , Mm          , Mm^Xm       , Xu          , Uu          , Rr          , Uu^Vud      , Uu          , Uu          , Uh          , Uh          , Xu          , Xu          , Qxu         , Uu          , Uu          , Rr          , Rr          , Uu^Vud      , Uu          , Uu          , Xu          , Xu          , Uh          , Qxu         , Xu          , Uh          , Xu          , Xu          
Mm^Xm       , Mm          , Mm^Xm       , Mm^Xm       , Xu          , Uu          , Uu          , Rr          , Rr          , Uu          , Uu^Uf       , Uu          , Uu          , Xu          , Xu          , Xu          , Uh          , Uu^Vud      , Rr          , Rr          , Rr          , Uu^Uf       , Uu^Uf       , Uu          , Rr          , Uh          , Uu          , Xu          , Xu          , Xu          
Mm^Xm       , Mm^Xm       , Xu          , Xu          , Qxu         , Uu          , Uu          , Uh          , Rr          , Xu          , Rr          , Rr          , Rr          , Uu^Uf       , Uu^Uf       , Xu          , Xu          , Uu          , Rr          , Uu          , Uh          , Rr          , Rr          , Rr          , Cud         , Rr          , Uu^Vud      , Uh          , Xu          , Xu          
Mm          , Mm^Xm       , Xu          , Xu          , Uu          , Uh          , Uu          , Uu          , Rr          , Rr          , Uh          , Uu^Uf       , Uh          , Rr          , Uh          , Qxu         , Xu          , Uu^Uf       , Rr          , Uh          , Xu          , Uu^Uf       , Uu          , Rr          , Rr          , Rr          , Uu          , Xu          , Xu          , Xu          
Mm          , Mm^Xm       , Xu          , Uh          , Rr          , Rr          , Rr          , Rr          , Uu          , Uh          , Xu          , Qxu         , Xu          , Rr          , Uu          , Xu          , Uu^Vud      , Uu          , Rr          , Uu          , Uu          , Xu          , Xu          , Uu^Vud      , Uu          , Uh          , Xu          , Xu          , Xu          , Xu          
Mm^Xm       , Mm^Xm       , Xu          , Uu          , Rr          , Cud         , Rr          , Uu          , Xu          , Xu          , Xu          , Qxu         , Uu          , Rr          , Rr          , Uh          , Uu          , Rr          , Cud         , Rr          , Uu^Vud      , Uh          , Xu          , Uh          , Xu          , Xu          , Xu          , Xu          , Xu          , Xu          
Mm          , Mm^Xm       , Xu          , Uu^Vud      , Uu          , Rr          , Uu          , Uu^Vud      , Uh          , Uh          , Xu          , Uu          , Uh          , Qxu         , Xu          , Rr          , Rr          , Rr          , Rr          , Rr          , Uu          , Xu          , Xu          , Xu          , Xu          , Xu          , Qxu         , Uu          , Uu          , Xu          
Mm          , Mm^Xm       , Xu          , Uh          , Uu^Uf       , Rr          , Uh          , Uu          , Uh          , Xu          , Xu          , Uh          , Xu          , Uh          , Uh          , Xu          , Xu          , Uh          , Uh          , Uh          , Xu          , Xu          , Xu          , Qxu         , Qxu         , Xu          , Xu          , Uu          , Xu          , Xu          
Mm^Xm       , Mm^Xm       , Xu          , Xu          , Uu          , Rr          , Uu          , Uh          , Xu          , Xu          , Xu          , Xu          , Mm^Xm       , Xu          , Xu          , Uh          , Xu          , Xu          , Xu          , Xu          , Xu          , Xu          , Xu          , Qxu         , Uu          , Qxu         , Xu          , Uu          , Xu          , Xu          
Mm^Xm       , Mm^Xm       , Mm^Xm       , Xu          , Cud         , Kud         , Cud         , Xu          , Xu          , Xu          , Mm^Xm       , Mm^Xm       , Mm          , Mm^Xm       , Mm^Xm       , Xu          , Xu          , Xu          , Xu          , Uu^Uf       , Uu^Uf       , Uu^Uf       , Xu          , Xu          , Xu          , Xu          , Qxu         , Qxu         , Xu          , Xu          
Mm          , Mm^Xm       , Mm^Xm       , Xu          , Mm          , Cud         , Hh          , Mm^Xm       , Mm^Xm       , Mm^Xm       , Mm          , Mm          , Mm          , Mm          , Mm          , Mm^Xm       , Mm^Xm       , Xu          , Xu          , Qxu         , Qxu         , Qxu         , Uu^Uf       , Xu          , Xu          , Qxu         , Qxu         , Xu          , Xu          , Xu          
Hh          , Mm          , Mm^Xm       , Mm^Xm       , Hh          , Gg          , Gg          , Mm          , Mm          , Mm          , Mm          , Hh          , Wo          , Mm          , Hh          , Mm          , Mm          , Mm^Xm       , Uu          , Uh          , Uu^Uf       , Qxu         , Uu^Uf       , Xu          , Xu          , Qxu         , Xu          , Xu          , Xu          , Xu          
Hh          , Mm          , Mm          , Mm^Xm       , 3 Mm        , Hh          , Wo          , Hh          , Hh          , Mm          , Wo          , Wo          , Wo          , Wo          , Wo          , Mm          , Mm          , Mm          , Mm          , Uu          , Xu          , Xu          , Xu          , Xu          , Xu          , Xu          , Xu          , Xu          , Xu          , Mm^Xm       
Gs^Fp       , Hh          , Hh          , Hh          , Mm          , Hh          , Wo          , Wo          , Wo          , Wo          , Wo          , Wo          , Wo          , Wo          , Wo          , Mm          , Mm          , Mm          , Mm^Xm       , Mm^Xm       , Mm^Xm       , Xu          , Xu          , Xu          , Mm^Xm       , Xu          , Xu          , Xu          , Mm^Xm       , Mm^Xm       
Gg          , Gs^Fp       , 2 Gg        , Hh          , Hh          , Wo          , Wo          , Wo          , Wo          , Wo          , Wo          , Wo          , Wo          , Wo          , Wo          , Hh          , Mm          , Mm          , Mm^Xm       , Mm^Xm       , Mm^Xm       , Mm^Xm       , Mm^Xm       , Mm^Xm       , Mm          , Mm^Xm       , Mm^Xm       , Mm^Xm       , Mm          , Mm          
Gg          , Gg          , Gs^Fp       , Gg          , Gg          , Wo          , Wo          , Wo          , Wo          , Wo          , Wo          , Wo          , Wo          , Wo          , Wo          , Hh          , Mm          , Mm          , Mm^Xm       , Mm^Xm       , Mm^Xm       , Mm^Xm       , Mm^Xm       , Mm          , Mm^Xm       , Mm          , Mm^Xm       , Mm^Xm       , Mm          , Mm          
