border_size=1
usage=map

_off^_usr   , _off^_usr   , _off^_usr   , _off^_usr   , _off^_usr   , _off^_usr   , _off^_usr   , _off^_usr   , _off^_usr   , _off^_usr   , _off^_usr   , _off^_usr   , _off^_usr   , _off^_usr   , _off^_usr   , Xu          , Xu          , Xu          , Xu          , Xu          , Xu          , Xu          , Xu          , Xu          , Xu          , Xu          , Xu          , Xu          , Xu          , Uu          , Uu          , Uu          , Uu          , Xu          , Xu          , Xu          , Xu          , Xu          , Xu          , Xu          , Xu          , Xu          , Xu          , Xu          , Xu          , Xu          
_off^_usr   , _off^_usr   , _off^_usr   , _off^_usr   , _off^_usr   , _off^_usr   , _off^_usr   , _off^_usr   , _off^_usr   , _off^_usr   , _off^_usr   , _off^_usr   , _off^_usr   , _off^_usr   , _off^_usr   , Xu          , Xu          , Xu          , Xu          , Xu          , Xu          , Xu          , Xu          , Xu          , Xu          , Xu          , Xu          , Xu          , Uu          , Uu          , Uu          , Uu          , Xu          , Xu          , Xu          , Xu          , Xu          , Xu          , Xu          , Xu          , Xu          , Xu          , Xu          , Xu          , Xu          , Xu          
_off^_usr   , _off^_usr   , _off^_usr   , _off^_usr   , _off^_usr   , _off^_usr   , _off^_usr   , _off^_usr   , _off^_usr   , _off^_usr   , _off^_usr   , _off^_usr   , _off^_usr   , _off^_usr   , _off^_usr   , Xu          , Xu          , Xu          , Xu          , Qxu         , Xu          , Xu          , Qxu         , Qxu         , Xu          , Xu          , Xu          , Uu          , Uu          , Uu          , Uu          , Xu          , Xu          , Xu          , Xu          , Qxu         , Qxu         , Xu          , Xu          , Xu          , Xu          , Xu          , Xu          , Xu          , Xu          , Xu          
_off^_usr   , _off^_usr   , _off^_usr   , _off^_usr   , _off^_usr   , _off^_usr   , _off^_usr   , _off^_usr   , _off^_usr   , _off^_usr   , _off^_usr   , _off^_usr   , _off^_usr   , _off^_usr   , _off^_usr   , Xu          , Xu          , Xu          , Uh          , Uh          , Qxu         , Qxu         , Xu          , Xu          , Xu          , Xu          , Uu          , Uu          , Qxu         , Xu          , Uu          , Xu          , Uu          , Xu          , Xu          , Xu          , Uh          , Uh          , Xu          , Uh          , Qxu         , Xu          , Xu          , Xu          , Xu          , Xu          
_off^_usr   , _off^_usr   , _off^_usr   , _off^_usr   , _off^_usr   , _off^_usr   , _off^_usr   , _off^_usr   , _off^_usr   , _off^_usr   , _off^_usr   , _off^_usr   , _off^_usr   , _off^_usr   , _off^_usr   , Xu          , Xu          , Qxu         , Qxu         , Uh          , Uh          , Uu^Uf       , Uu^Uf       , Xu          , Xu          , Uu          , Uu          , Uu          , Uu          , Uu          , Uu          , Qxu         , Uu          , Uu          , Xu          , Xu          , Xu          , Uh          , Uh          , Xu          , Xu          , Uh          , Xu          , Xu          , Xu          , Xu          
_off^_usr   , _off^_usr   , _off^_usr   , _off^_usr   , _off^_usr   , _off^_usr   , _off^_usr   , _off^_usr   , _off^_usr   , _off^_usr   , _off^_usr   , _off^_usr   , _off^_usr   , _off^_usr   , _off^_usr   , Xu          , Xu          , Qxu         , Xu          , Uu^Uf       , Xu          , Xu          , Qxu         , Qxu         , Xu          , Xu          , Uu          , Xu          , Xu          , Xu          , Uu          , Uu          , Qxu         , Xu          , Xu          , Xu          , Xu          , Qxu         , Xu          , Xu          , Qxu         , Xu          , Xu          , Xu          , Xu          , Xu          
_off^_usr   , _off^_usr   , _off^_usr   , _off^_usr   , _off^_usr   , _off^_usr   , _off^_usr   , _off^_usr   , _off^_usr   , _off^_usr   , _off^_usr   , _off^_usr   , _off^_usr   , _off^_usr   , _off^_usr   , Xu          , Xu          , Xu          , Xu          , Uu^Uf       , Xu          , Xu          , Xu          , Qxu         , Uu^Uf       , Uu          , Uu          , Xu          , Qxu         , Qxu         , Uu          , Xu          , Qxu         , Qxu         , Xu          , Xu          , Xu          , Qxu         , Xu          , Xu          , Xu          , Xu          , Xu          , Xu          , Xu          , Xu          
_off^_usr   , _off^_usr   , _off^_usr   , _off^_usr   , _off^_usr   , _off^_usr   , _off^_usr   , _off^_usr   , _off^_usr   , _off^_usr   , _off^_usr   , _off^_usr   , _off^_usr   , _off^_usr   , _off^_usr   , Xu          , Xu          , Xu          , Xu          , Xu          , Uh          , Xu          , Uu          , Uu^Uf       , Uu^Vu       , Uu          , Ur          , Uu          , Ur          , Xu          , Uu          , Xu          , Xu          , Qxu         , Qxu         , Xu          , Xu          , Xu          , Xu          , Uh          , Xu          , Qxu         , Xu          , Xu          , Xu          , Xu          
_off^_usr   , _off^_usr   , _off^_usr   , _off^_usr   , _off^_usr   , _off^_usr   , _off^_usr   , _off^_usr   , _off^_usr   , _off^_usr   , _off^_usr   , _off^_usr   , _off^_usr   , _off^_usr   , _off^_usr   , Xu          , Xu          , Xu          , Uh          , Uh          , Uu          , Uu          , Uu          , Uu          , Uu          , Ur          , Uu^Vu       , Ur          , Uu          , Ur          , Ur          , Uu          , Xu          , Xu          , Uu          , Uu          , Uu          , Xu          , Xu          , Uh          , Uh          , Qxu         , Xu          , Xu          , Xu          , Xu          
_off^_usr   , _off^_usr   , _off^_usr   , _off^_usr   , _off^_usr   , _off^_usr   , _off^_usr   , _off^_usr   , _off^_usr   , _off^_usr   , _off^_usr   , _off^_usr   , _off^_usr   , _off^_usr   , _off^_usr   , Xu          , Xu          , Xu          , Uh          , Xu          , Qxu         , Xu          , Uu          , Uu          , Uu^Vu       , Ur          , Uu          , Uu          , Uu          , Xu          , Uu          , Ur          , Ur          , Uu^Vu       , Ww          , Ww          , Wo          , Uu^Uf       , Xu          , Xu          , Xu          , Qxu         , Uh          , Xu          , Xu          , Xu          
_off^_usr   , _off^_usr   , _off^_usr   , _off^_usr   , _off^_usr   , _off^_usr   , _off^_usr   , _off^_usr   , _off^_usr   , _off^_usr   , _off^_usr   , _off^_usr   , _off^_usr   , _off^_usr   , _off^_usr   , Xu          , Xu          , Uu^Uf       , Uu          , Uu          , Uh          , Xu          , Uu^Uf       , Uu^Uf       , Uu          , Ur          , Ur          , Uu          , Xu          , Xu          , Uu          , Xu          , Uu          , Ur          , Ai          , Wo          , Wo          , Uu          , Xu          , Xu          , Xu          , Xu          , Xu          , Xu          , Xu          , Xu          
_off^_usr   , _off^_usr   , _off^_usr   , _off^_usr   , _off^_usr   , _off^_usr   , _off^_usr   , _off^_usr   , _off^_usr   , _off^_usr   , _off^_usr   , _off^_usr   , _off^_usr   , _off^_usr   , _off^_usr   , Xu          , Xu          , Xu          , Xu          , Uh          , Uu          , Xu          , Xu          , Xu          , Xu          , Uu          , Ur          , Xu          , Xu          , Xu          , Xu          , Qxu         , Xu          , Ur          , Ur          , Ai          , Uu          , Uu          , Xu          , Xu          , Uh          , Xu          , Xu          , Xu          , Xu          , Xu          
_off^_usr   , _off^_usr   , _off^_usr   , _off^_usr   , _off^_usr   , _off^_usr   , _off^_usr   , _off^_usr   , _off^_usr   , _off^_usr   , _off^_usr   , _off^_usr   , _off^_usr   , _off^_usr   , _off^_usr   , Xu          , Xu          , Xu          , Uu^Vu       , Uu          , Ur          , Uu          , Uu^Vu       , Xu          , Qxu         , Ur          , Uu          , Xu          , Cud         , Qxu         , Qxu         , Xu          , Xu          , Xu          , Ur          , Uu          , Ur          , Xu          , Uu          , Qxu         , Qxu         , Xu          , Xu          , Xu          , Xu          , Xu          
_off^_usr   , _off^_usr   , _off^_usr   , _off^_usr   , _off^_usr   , _off^_usr   , _off^_usr   , _off^_usr   , _off^_usr   , _off^_usr   , _off^_usr   , _off^_usr   , _off^_usr   , _off^_usr   , _off^_usr   , Xu          , Xu          , Xu          , Uu          , Ur          , Ur          , Ur          , Uu          , Xu          , Xu          , Ur          , Uu^Vu       , Uu          , Cud         , Cud         , Cud         , Xu          , Uu          , Ur          , Uu          , Ur          , Xu          , Ur          , Uu          , Xu          , Qxu         , Uh          , Xu          , Xu          , Xu          , Xu          
_off^_usr   , _off^_usr   , _off^_usr   , _off^_usr   , _off^_usr   , _off^_usr   , _off^_usr   , _off^_usr   , _off^_usr   , _off^_usr   , _off^_usr   , _off^_usr   , _off^_usr   , _off^_usr   , _off^_usr   , Xu          , Xu          , Xu          , Uu          , Ur          , Ur          , Ur          , Uu          , Cud         , Uu          , Ur          , Ur          , Uu          , Uu          , 2 Kud       , Cud         , Cud         , Ur          , Ur          , Xu          , Xu          , Uu          , Ur          , Uu          , Qxu         , Xu          , Uh          , Xu          , Xu          , Xu          , Xu          
_off^_usr   , _off^_usr   , _off^_usr   , _off^_usr   , _off^_usr   , _off^_usr   , _off^_usr   , _off^_usr   , _off^_usr   , _off^_usr   , _off^_usr   , _off^_usr   , _off^_usr   , _off^_usr   , _off^_usr   , Xu          , Xu          , Xu          , Xu          , Uu          , Uu^Vu       , Uu          , Cud         , Cud         , Ur          , Uu          , Ur          , Uu          , Ur          , Ur          , Uu          , Ur          , Uu          , Xu          , Xu          , Xu          , Qxu         , Ur          , Uu^Vu       , Xu          , Xu          , Xu          , Uh          , Uh          , Xu          , Xu          
_off^_usr   , _off^_usr   , _off^_usr   , _off^_usr   , _off^_usr   , _off^_usr   , _off^_usr   , _off^_usr   , _off^_usr   , _off^_usr   , _off^_usr   , _off^_usr   , _off^_usr   , _off^_usr   , _off^_usr   , Xu          , Xu          , Xu          , Xu          , Xu          , Xu          , Xu          , Qxu         , Uu          , Uu          , Ur          , Ur          , Ur          , Ur          , Ur          , Ur          , Ur          , Ur          , Uu          , Ur          , Xu          , Uu^Ufi      , Ur          , Uh          , Xu          , Xu          , Uh          , Xu          , Xu          , Xu          , Xu          
_off^_usr   , _off^_usr   , _off^_usr   , _off^_usr   , _off^_usr   , _off^_usr   , _off^_usr   , _off^_usr   , _off^_usr   , _off^_usr   , _off^_usr   , _off^_usr   , _off^_usr   , _off^_usr   , _off^_usr   , Xu          , Xu          , Xu          , Xu          , Xu          , Uu          , Uu          , Ur          , Ur          , Ur          , Ur          , Uu          , Ur          , Uu^Vu       , Uu          , Uu          , Uu^Vu       , Xu          , Ur          , Uu          , Ur^Ii       , Ur^Ii       , Ur          , Uu^Ii       , Xu          , Xu          , Qxu         , Uh          , Xu          , Xu          , Xu          
_off^_usr   , _off^_usr   , _off^_usr   , _off^_usr   , _off^_usr   , _off^_usr   , _off^_usr   , _off^_usr   , _off^_usr   , _off^_usr   , _off^_usr   , _off^_usr   , _off^_usr   , _off^_usr   , _off^_usr   , Xu          , Xu          , Uu^Uf       , Qxu         , Xu          , Ur          , Ur          , Xu          , Uu          , Uu          , Uu          , Ur          , Ur          , Uu          , Uu          , Uh          , Xu          , Xu          , Xu          , Uh          , Uu^Ii       , Ur^Ii       , Ur^Ii       , Uu^Ufi      , Xu          , Xu          , Qxu         , Xu          , Xu          , Xu          , Xu          
_off^_usr   , _off^_usr   , _off^_usr   , _off^_usr   , _off^_usr   , _off^_usr   , _off^_usr   , _off^_usr   , _off^_usr   , _off^_usr   , _off^_usr   , _off^_usr   , _off^_usr   , _off^_usr   , _off^_usr   , Xu          , Xu          , Qxu         , Xu          , Uu          , Ur          , Xu          , Xu          , Uu          , Uu          , Ur          , Uu^Vu       , Uu          , Uu          , Uh          , Xu          , Xu          , Qxu         , Uh          , Ur          , Ur^Ii       , Uu^Ii       , Uu^Ii       , Uu^Ufi      , Uu^Ufi      , Xu          , Qxu         , Xu          , Xu          , Mm^Xm       , Mm^Xm       
_off^_usr   , _off^_usr   , _off^_usr   , _off^_usr   , _off^_usr   , _off^_usr   , _off^_usr   , _off^_usr   , _off^_usr   , _off^_usr   , _off^_usr   , _off^_usr   , _off^_usr   , _off^_usr   , _off^_usr   , Xu          , Xu          , Qxu         , Qxu         , Uu          , Ur          , Xu          , Qxu         , Uu          , Uu          , Ur          , Uu          , Uu          , Uu          , Uu          , Xu          , Xu          , Xu          , Uh          , Ur          , Ur          , Uh          , Uh          , Xu          , Xu          , Xu          , Xu          , Xu          , Mm^Xm       , Mm          , Mm          
_off^_usr   , _off^_usr   , _off^_usr   , _off^_usr   , _off^_usr   , _off^_usr   , _off^_usr   , _off^_usr   , _off^_usr   , _off^_usr   , _off^_usr   , _off^_usr   , _off^_usr   , _off^_usr   , _off^_usr   , Xu          , Xu          , Xu          , Xu          , Uu          , Ur          , Uu          , Uu^Vu       , Xu          , Ur          , Ur          , Uu^Uf       , Uu^Uf       , Qxu         , Qxu         , Qxu         , Xu          , Xu          , Xu          , Ur          , Uu          , Xu          , Xu          , Xu          , Xu          , Xu          , Xu          , Mm^Xm       , Mm^Xm       , Mm          , Ha          
_off^_usr   , _off^_usr   , _off^_usr   , _off^_usr   , _off^_usr   , _off^_usr   , _off^_usr   , _off^_usr   , _off^_usr   , _off^_usr   , _off^_usr   , _off^_usr   , _off^_usr   , _off^_usr   , _off^_usr   , Xu          , Xu          , Xu          , Xu          , Xu          , Ur          , Ur          , Ur          , Ur          , Ur          , Uu          , Xu          , Xu          , Xu          , Xu          , Xu          , Xu          , Uh          , Xu          , Ur          , Uu^Vu       , Qxu         , Xu          , Xu          , Xu          , Xu          , Mm^Xm       , Mm^Xm       , Mm^Xm       , Ha          , Ha          
_off^_usr   , _off^_usr   , _off^_usr   , _off^_usr   , _off^_usr   , _off^_usr   , _off^_usr   , _off^_usr   , _off^_usr   , _off^_usr   , _off^_usr   , _off^_usr   , _off^_usr   , _off^_usr   , _off^_usr   , Xu          , Xu          , Xu          , Ur          , Ur          , Xu          , Uu          , Xu          , Ur          , Ur          , Xu          , Xu          , Xu          , Xu          , Xu          , Xu          , Xu          , Ur          , Ur          , Cud         , Ur          , Uu          , Xu          , Xu          , Xu          , Mm^Xm       , Mm^Xm       , Mm          , Mm          , Ha          , Gg          
_off^_usr   , _off^_usr   , _off^_usr   , _off^_usr   , _off^_usr   , _off^_usr   , _off^_usr   , _off^_usr   , _off^_usr   , _off^_usr   , _off^_usr   , _off^_usr   , _off^_usr   , _off^_usr   , _off^_usr   , Xu          , Xu          , Xu          , Uu          , Ur          , Uu          , Xu          , Xu          , Uu          , Ur          , Uu          , Ur          , Uu^Vu       , Ur          , Uu^Uf       , Ur          , Ur          , Uu^Vu       , Ur          , Ur          , Ur          , Ur          , Xu          , Xu          , Mm^Xm       , Mm          , Mm          , Mm          , Ha          , Hh          , Gg          
_off^_usr   , _off^_usr   , _off^_usr   , _off^_usr   , _off^_usr   , _off^_usr   , _off^_usr   , _off^_usr   , _off^_usr   , _off^_usr   , _off^_usr   , _off^_usr   , _off^_usr   , _off^_usr   , _off^_usr   , Xu          , Xu          , Xu          , Mm^Xm       , Uu^Ii       , Uu^Ii       , Hh^Ii       , Xu          , Qxu         , Qxu         , Ur          , Uu          , Ur          , Uu^Ii       , Ur          , Uu^Uf       , Uu          , Xu          , Uh          , Xu          , Uu          , Ur          , Uu          , Xu          , Mm^Xm       , Mm          , Mm          , Hh          , Hh          , Gg          , Gg          
_off^_usr   , _off^_usr   , _off^_usr   , _off^_usr   , _off^_usr   , _off^_usr   , _off^_usr   , _off^_usr   , _off^_usr   , _off^_usr   , _off^_usr   , _off^_usr   , _off^_usr   , _off^_usr   , _off^_usr   , Xu          , Xu          , Mm^Xm       , Hh^Ii       , Uu^Ii       , Hh^Ii       , Hh^Ii       , Mm^Xm       , Xu          , Xu          , Qxu         , Xu          , Uu^Ii       , Xu          , Uu^Uf       , Xu          , Qxu         , Xu          , Xu          , Mm^Xm       , Xu          , Xu          , Ur          , Cud         , Mm^Xm       , Ha          , Hh          , Ww          , Ww          , Ww          , Aa^Fpa      
_off^_usr   , _off^_usr   , _off^_usr   , _off^_usr   , _off^_usr   , _off^_usr   , _off^_usr   , _off^_usr   , _off^_usr   , _off^_usr   , _off^_usr   , _off^_usr   , _off^_usr   , _off^_usr   , _off^_usr   , Xu          , Xu          , Mm^Xm       , Mm^Xm       , Mm^Ii       , Hh^Ii       , Mm^Ii       , Mm^Xm       , Xu          , Xu          , Xu          , Xu          , Xu          , Xu          , Xu          , Xu          , Xu          , Mm^Xm       , Mm^Xm       , Mm^Xm       , Mm^Xm       , Mm^Xm       , Cud         , Rr          , Ha          , Wo          , Ww          , Wo          , Wo          , Wo          , Wo          
_off^_usr   , _off^_usr   , _off^_usr   , _off^_usr   , _off^_usr   , _off^_usr   , _off^_usr   , _off^_usr   , _off^_usr   , _off^_usr   , _off^_usr   , _off^_usr   , _off^_usr   , _off^_usr   , _off^_usr   , Xu          , Xu          , Xu          , Xu          , Mm^Xm       , Mm^Xm       , Mm^Xm       , Mm^Xm       , Mm^Xm       , Mm^Xm       , Xu          , Mm^Xm       , Xu          , Mm^Xm       , Xu          , Mm^Xm       , Mm^Xm       , Ai          , Mm          , Mm          , Mm^Xm       , Mm^Xm       , Ha          , Ha          , Wo^Bw\      , Wo^Bw\      , Wo          , Ww          , Ww          , Ww          , Ww          
_off^_usr   , _off^_usr   , _off^_usr   , _off^_usr   , Xu          , Xu          , Xu          , _off^_usr   , _off^_usr   , _off^_usr   , _off^_usr   , _off^_usr   , _off^_usr   , _off^_usr   , _off^_usr   , Xu          , Xu          , Xu          , Xu          , Xu          , Mm^Xm       , Mm^Xm       , Mm          , Mm          , Mm          , Mm^Xm       , Mm          , Mm^Xm       , Mm          , Mm^Xm       , Mm          , Ai          , Ai          , Mm          , Ha          , Mm          , Ha          , Ha          , Wo          , Wo          , Ww          , Gg          , Gs^Fp       , Gg          , Gg          , Gg          
_off^_usr   , _off^_usr   , Xu          , Xu          , Xu          , Xu          , Ql          , Xu          , Xu          , _off^_usr   , _off^_usr   , _off^_usr   , _off^_usr   , _off^_usr   , _off^_usr   , Xu          , Mm^Xm       , Mm^Xm       , Mm^Xm       , Mm^Xm       , Mm          , Mm          , Mm          , Mm          , Mm          , Mm          , Mm          , Mm          , Ha          , Mm          , Mm          , Mm          , Wo          , Ha          , Hh          , Ha          , Gg          , Gg          , Wo          , Ww          , Gg          , Gg          , Gs^Fp       , Gs^Fp       , Gs^Fp       , Gg          
Xu          , Xu          , Xu          , Xu          , Ql          , Ql          , Uu          , Ql          , Ql          , Xu          , Xu          , _off^_usr   , _off^_usr   , _off^_usr   , _off^_usr   , Xu          , Mm^Xm       , Mm^Xm       , Mm          , Mm          , Mm          , Mm          , Ha          , Ha          , Ha          , Ha          , Ha          , Ha          , Hh          , Ha          , Hh          , Ha          , Wo          , Ww          , Wo          , Gg          , Gg          , Ww          , Wo          , Gs^Fp       , Gg          , Gg          , Gs^Fp       , Gg          , Gg          , Gg          
Uu          , Xu          , Uu          , Ql          , Uu          , Uu          , Cud         , Uu          , Uu          , Ql          , Xu          , _off^_usr   , _off^_usr   , _off^_usr   , _off^_usr   , Mm^Xm       , Mm^Xm       , Mm          , Mm          , Mm          , Ha          , Hh          , Hh          , Hh          , Hh          , Hh          , Hh          , Gg          , Gg          , Gg          , Hh          , Mm          , Mm          , Ww          , Wo          , Ww          , Wo          , Wo          , Ww          , Gs^Fp       , Gg          , Gg          , Hh          , Ha          , Gg          , Gg          
Rr          , Uu          , Uu          , Uu          , Uu          , Cud         , 1 Kud       , Cud         , Uu          , Ql          , Xu          , _off^_usr   , _off^_usr   , _off^_usr   , _off^_usr   , Mm^Xm       , Mm          , Mm          , Mm          , Mm          , Ha          , Hh          , Gg          , Gg          , Gg          , Gg          , Gg          , Gg          , Gg          , Gg          , Hh          , Mm          , Mm          , Mm          , Hh          , Ww          , Ai          , Ww          , Mm          , Gg          , Gg          , Ha          , Mm          , Mm          , Hh          , Gg          
Uu^Vud      , Rr          , Rr          , Uu          , Rr          , Cud         , Cud         , Cud         , Uu          , Ql          , Xu          , _off^_usr   , _off^_usr   , _off^_usr   , _off^_usr   , Mm^Xm       , Mm          , Mm          , Hh          , Ha          , Gg          , Gg          , Gs^Fp       , Gg          , Gg          , Gg          , Gg          , Gg          , Gg          , Gg          , Ha          , Mm          , Hh          , Ha          , Hh          , Ha          , Mm          , Mm          , Mm          , Hh          , Gg          , Gg          , Mm          , Mm          , Hh          , Gg          
Uu^Uf       , Rr          , Rr          , Rr          , Uu          , Uu          , Uu          , Uu          , Ql          , Ql          , Xu          , _off^_usr   , _off^_usr   , _off^_usr   , _off^_usr   , Mm^Xm       , Mm          , Mm          , Hh          , Gg          , Gg          , Gs^Fp       , Gs^Fp       , Aa^Fpa      , Hh          , Gg          , Mm          , Mm          , Mm          , Mm          , Gg          , Hh          , Hh          , Gg          , Gg          , Hh          , Hh          , Mm          , Hh          , Hh          , Gg          , Hh          , Hh          , Hh          , Gg          , Gg          
Rr          , Rr          , Rr          , Rr          , Uu          , Uu          , Uu          , Ql          , Xu          , Xu          , Xu          , _off^_usr   , _off^_usr   , _off^_usr   , _off^_usr   , Mm          , Ha          , Ha          , Gg          , Gg          , Gg          , Aa^Fpa      , Gg          , Gg          , Gg          , Ha          , Mm          , Mm          , Gg          , Mm          , Gg          , Hh          , Gg          , Gg          , Gg          , Ha          , Gg          , Ha          , Gg          , Gg          , Gs^Fp       , Gg          , Gg          , Gg          , Gg          , Gg          
