border_size=1
usage=map

Xu          , Xu          , Xu          , Xu          , Xu          , Xu          , Xu          , Xu          , Mm^Xm       , Mm          , Ha          , Hh          , Hh          , Hh          , Hh          , Hh          , Hh          , Hh          , Hh          , Hh          , Hh          , Hh          , Hh          , Mm          , Gg          , Gg          , Hh          , Hh          , Hh          , Hh          , Hh          , Mm          , Hh          , Mm          , Gg          , Hh          , Hh          , Mm          
Xu          , Xu          , Xu          , Xu          , Xu          , Xu          , Xu          , Xu          , Xu          , Mm^Xm       , Mm          , Ha          , Mm          , Hh          , Ha          , Ha          , Mm          , Mm          , Ha          , Hh          , Ha          , Hh          , Aa          , Gg          , Aa          , Hh          , Hh          , Hh          , Ce          , Hh          , Ce          , Hh          , Hh          , Hh          , Gg          , Gg          , Gg          , Hh          
Xu          , Qxu         , Uh          , Xu          , Uh          , Uh          , Uh          , Xu          , Xu          , Mm^Xm       , Mm^Xm       , Mm          , Mm          , Mm          , Mm          , Mm          , Mm          , Mm          , Mm          , Ha          , Mm          , Hh          , Hh          , Aa          , Hh          , Hh          , Ms          , Ha          , Ce          , Ke          , Ce          , Re^Vct      , Hh          , Hh          , Hh          , Hh          , Hh          , Hh          
Xu          , Uh          , Xu          , Qxu         , Uh          , Xu          , Uu          , Uu          , Xu          , Xu          , Xu          , Mm^Xm       , Mm^Xm       , Mm          , Mm          , Mm          , Mm          , Mm          , Mm          , Mm          , Mm          , Mm          , Mm          , Ha          , Hh          , Hh          , Mm          , Ms          , Hh          , Hh          , Re^Vct      , Ce          , Mm          , Mm          , Mm          , Hh          , Hh          , Hh          
Xu          , Xu          , Xu          , Xu          , Uh          , Uu          , Uu          , Uu          , Qxu         , Xu          , Xu          , Xu          , Xu          , Mm^Xm       , Mm^Xm       , Mm          , Mm^Xm       , Mm          , Mm^Xm       , Mm          , Mm          , Mm          , Mm          , Hh          , Ha          , Ha          , Mm          , Hh          , Hh          , Hh          , Gg          , Hh          , Mm          , Mm          , Mm          , Hh          , Hh          , Hh          
Xu          , Xu          , Xu          , Xu          , Xu          , Uu          , Uu          , Uu^Vud      , Ur          , Xu          , Ur          , Uu          , Cud         , Xu          , Xu          , Mm^Xm       , Xu          , Mm^Xm       , Mm^Xm       , Mm^Xm       , Mm^Xm       , Mm          , Mm^Xm       , Mm          , Mm          , Mm          , Mm          , Hh          , Hh          , Gg          , Gg          , Hh          , Hh          , Mm          , Hh          , Hh          , Gg          , Hh          
Xu          , Xu          , Xu          , Xu          , Uh          , Xu          , Uh          , Ur          , Uu          , Ur          , Uu          , Ur          , Cud         , Kud         , Cud         , Xu          , Xu          , Xu          , Xu          , Xu          , Xu          , Mm^Xm       , Mm^Xm       , Mm^Xm       , Mm^Xm       , Mm          , Mm          , Mm          , Hh          , Gg          , Hh          , Hh          , Hh          , Hh          , Aa          , Aa          , Gg          , Hh          
Xu          , Xu          , Xu          , Uh          , Uu          , Xu          , Uu^Uf       , Ur          , Uh          , Xu          , Xu          , Ur          , Ur          , Cud         , Uu          , Uu          , Uu          , Uu          , Uh          , Qxu         , Uh          , Xu          , Xu          , Xu          , Xu          , Mm^Xm       , Mm          , Hh          , Hh          , Gg          , Mm          , Hh          , Ha          , Hh          , Aa          , Aa          , Hh          , Gg          
Xu          , Xu          , Uh          , Uh          , Uu          , Uu^Uf       , Uu          , Ur          , Uh          , Xu          , Xu          , Uh          , Uu^Vud      , Ur          , Ur          , Uu          , Uu          , Uu          , Uu          , Uh          , Qxu         , Xu          , Xu          , Uh          , Uh          , Xu          , Cud^Ii      , Hh          , Hh          , Hh          , Mm          , Mm          , Mm          , Mm          , Mm          , Hh          , Hh          , Hh          
Xu          , Xu          , Uh          , Xu          , Uu          , Uu^Uf       , Uu^Vud      , Ur          , Uu          , Uh          , Uh          , Uh          , Uu          , Uh          , Ur          , Uu          , Uu          , Uu          , Ur          , Uu^Vud      , Qxu         , Xu          , Xu          , Uh          , Uh^Ii       , Uh          , Ur          , Cud^Ii      , Cud^Ii      , Mm          , Mm          , Mm          , Mm          , Mm          , Mm          , Hh          , Hh          , Hh          
Xu          , Xu          , Xu          , Xu          , Uu          , Uu          , Uu^Uf       , Uu          , Uu^Uf       , Uu^Uf       , Uh          , Uh          , Uh          , Uh          , Uu          , Ur          , Ur          , Ur          , Uu          , Qxu         , Uh          , Uh          , Uu^Uf       , Uh          , Ur          , Ur          , Uu^Ii       , Uh          , Uh          , Xu          , Mm^Xm       , Mm          , Mm          , Mm          , Mm          , Gg          , Hh          , Hh          
Xu          , Xu          , Qxu         , Uh          , Uu          , Uu^Uf       , Uu^Uf       , Uu          , Uu^Ii       , Uu^Uf       , Uu          , Uh          , Uh          , Uh          , Uh          , Ur          , Uu^Vud      , Ur          , Qxu^Bs\     , Qxu         , Uh          , Uu^Uf       , Uu^Uf       , Uh          , Ur          , Uu^Vud      , Uh^Ii       , Uu^Ii       , Uu^Ii       , Xu          , Mm^Xm       , Mm^Xm       , Hh          , Hh          , Gg          , Gg          , Hh          , Hh          
Xu          , Xu          , Qxu         , Xu          , Xu          , Xu          , Uu          , Uu^Ii       , Uu^Ii       , Uu^Ii       , Uu          , Uh          , Uh          , Uh          , Uh          , Ur          , Qxu^Bs\     , Qxu         , Uu          , Ur          , Ur          , Uu          , Uu          , Uh          , Ur          , Uh          , Uh^Ii       , Uu          , Uh          , Xu          , Mm^Xm       , Mm^Xm       , Hh          , Hh          , Hh          , Hh          , Hh          , Hh          
Xu          , Xu          , Uu^Uf       , Uu^Uf       , Xu          , Uu          , Xu          , Uu          , Uu          , Uu^Ii       , Uu          , Uh          , Xu          , Xu          , Xu          , Qxu         , Uh          , Ur          , Ur          , Uu^Vud      , Ur          , Uu          , Ur          , Ur          , Uu          , Uu^Ii       , Uu^Ii       , Uh          , Uh          , Xu          , Xu          , Mm^Xm       , Mm          , Ha          , Ms          , Hh          , Hh          , Hh          
Xu          , Xu          , Xu          , Xu          , Uh          , Xu          , Uh          , Uh          , Uh          , Uh          , Qxu         , Qxu         , Qxu         , Xu          , Xu          , Uh          , Uu          , Uu          , Uu          , Ur          , Uu          , Ur          , Uu          , Uu          , Uu          , Uu^Ii       , Uu          , Uh          , Uh          , Uh          , Xu          , Mm^Xm       , Mm^Xm       , Mm          , Mm          , Hh          , Hh          , Hh          
Xu          , Xu          , Xu          , Xu          , Uh          , Qxu         , Xu          , Xu          , Xu          , Xu          , Xu          , Uh          , Uu          , Xu          , Uh          , Uu          , Uu          , Uu          , Uu          , Uu          , Ur          , Ur          , Xu          , Qxu         , Uh          , Uu          , Uh          , Uh          , Uh          , Xu          , Xu          , Mm^Xm       , Mm^Xm       , Mm          , Mm          , Hh          , Hh          , Hh          
Xu          , Xu          , Xu          , Xu          , Xu          , Uu^Uf       , Xu          , Xu          , Qlf         , Xu          , Uh          , Uh          , Uh          , Uu          , Uu^Vud      , Ur          , Ur          , 1 Ur        , Ur          , Ur          , Ur          , Uh          , Qxu         , Uh          , Uh          , Uh          , Uu^Vud      , Uh          , Xu          , Xu          , Xu          , Mm^Xm       , Mm          , Mm          , Mm          , Ha          , Hh          , Hh          
Xu          , Xu          , Xu          , Xu          , Uh          , Xu          , Xu          , Qlf         , Qlf         , Ql          , Uu^Ii       , Xu          , Xu          , Uu          , Uh          , Uu          , Uu          , Uu          , Uu^Uf       , Uu^Uf       , Ur          , Uu          , Uh          , Uh          , Xu          , Uu          , Uu          , Uh          , Xu          , Xu          , Mm^Xm       , Mm^Xm       , Mm          , Mm          , Mm          , Ha          , Hh          , Hh          
Xu          , Xu          , Xu          , Uh          , Qxu         , Uh          , Xu          , Xu          , Ql          , Ql          , Cud         , Xu          , Uu^Ii       , Uu          , Uu          , Uh          , Uh          , Uh          , Uh          , Uu^Uf       , Uu          , Uu^Vud      , Xu          , Xu          , Uh          , Uu          , Uu          , Uu          , Uu^Uf       , Xu          , Xu          , Mm^Xm       , Mm^Xm       , Mm          , Mm          , Mm          , Ms          , Hh          
Xu          , Xu          , Xu          , Xu          , Qxu         , Xu          , Xu          , Qlf         , Xu          , Uu^Ii       , Cud         , Cud         , Uu          , Uu          , Ql          , Xu          , Xu          , Uh          , Xu          , Xu          , Ww          , Wwf         , Ww          , Xu          , Uh          , Uu          , Uu          , Uu^Uf       , Uu^Uf       , Xu          , Xu          , Mm^Xm       , Mm^Xm       , Mm          , Mm          , Mm          , Mm          , Mm          
Xu          , Xu          , Xu          , Qxu         , Xu          , Xu          , Xu          , Xu          , Qlf         , Xu          , Ql          , Cud         , Uu^Ii       , Uu^Ufi      , Uu^Ufi      , Xu          , Uh          , Xu          , Ww          , Ww          , Wo          , Wo          , Wo          , Ww          , Wwf         , Uu          , Uu^Uf       , Uu          , Uu          , Uu          , Xu          , Xu          , Xu          , Mm^Xm       , Mm^Xm       , Mm^Xm       , Mm^Xm       , Mm          
Xu          , Xu          , Qxu         , Xu          , Qxu         , Uh          , Xu          , Xu          , Xu          , Qlf         , Ql          , Uu          , Uu^Ii       , Uu^Uf       , Ql          , Uh          , Xu          , Xu          , Xu          , Wo          , Wo          , Wo          , Wo          , Ww          , Ww          , Uh          , Uh          , Uu          , Uu          , Uu          , Xu          , Xu          , Xu          , Xu          , Xu          , Xu          , Xu          , Mm^Xm       
Xu          , Xu          , Xu          , Uh          , Xu          , Uh          , Xu          , Uh          , Xu          , Xu          , Xu          , Uh          , Xu          , Ql          , Xu          , Xu          , Qxu         , Qxu         , Qxu         , Xu          , Wo          , Wo          , Wo          , Wo          , Xu          , Xu          , Xu          , Uh          , Xu          , Uh          , Xu          , Xu          , Qxu         , Uh          , Xu          , Xu          , Xu          , Xu          
Xu          , Xu          , Xu          , Xu          , Xu          , Xu          , Xu          , Xu          , Xu          , Xu          , Xu          , Xu          , Xu          , Xu          , Xu          , Xu          , Xu          , Xu          , Xu          , Xu          , Xu          , Xu          , Xu          , Xu          , Xu          , Xu          , Xu          , Xu          , Xu          , Xu          , Xu          , Xu          , Xu          , Xu          , Xu          , Xu          , Xu          , Xu          
