border_size=1
usage=map

_off^_usr   , _off^_usr   , _off^_usr   , _off^_usr   , Xu          , Xu          , Xu          , _off^_usr   , _off^_usr   , _off^_usr   , _off^_usr   , _off^_usr   , _off^_usr   , _off^_usr   , _off^_usr   , Xu          , Xu          , Xu          , Xu          , Xu          , Qlf         , Xu          , Xu          , Xu          , Xu          , Xu          , Xu          , Xu          , Xu          , Xu          , Xu          , Xu          
_off^_usr   , _off^_usr   , Xu          , Xu          , Xu          , Xu          , Ql          , Xu          , Xu          , _off^_usr   , _off^_usr   , _off^_usr   , _off^_usr   , _off^_usr   , _off^_usr   , Xu          , Xu          , Xu          , Qlf         , Ql          , Kud         , Qlf         , Ql          , Xu          , Xu          , Xu          , Xu          , Xu          , Xu          , Xu          , Xu          , Xu          
Xu          , Xu          , Xu          , Xu          , Ql          , Ql          , Uu          , Ql          , Ql          , Xu          , Xu          , _off^_usr   , _off^_usr   , _off^_usr   , _off^_usr   , Xu          , Ql          , Qlf         , Kud         , Cud         , Rr          , Cud         , Ql          , Xu          , Xu          , Xu          , Xu          , Xu          , Xu          , Xu          , Rr          , Rr          
Uu          , Xu          , Uu          , Ql          , Uu          , Uu          , Cud         , Uu          , Uu          , Ql          , Xu          , _off^_usr   , _off^_usr   , _off^_usr   , _off^_usr   , Xu          , Qlf         , Cud         , Rr          , Rr          , Rr          , Rr          , Ql          , Xu          , Xu          , Xu          , Ql          , Xu          , Rr          , Rr          , Xu          , Xu          
Rr          , Uu          , Uu^Vud      , Uu          , Uu          , Cud         , 1 Kud       , Cud         , Uu          , Ql          , Xu          , _off^_usr   , _off^_usr   , _off^_usr   , _off^_usr   , Xu          , Qlf         , Kud         , Rr          , Rr          , Rr          , Rr          , Ql          , Xu          , Uu^Vud      , Uu^Vud      , Rr          , Rr          , Ql          , Xu          , Xu          , Xu          
Uu^Vud      , Rr          , Rr          , Uu          , Rr          , Cud         , Cud         , Cud         , Uu          , Ql          , Xu          , _off^_usr   , _off^_usr   , _off^_usr   , _off^_usr   , Xu          , Ql          , Cud         , Rr          , Rr          , Rr          , Rr          , Rr          , Uu^Vud      , Rr          , Rr          , Rr          , Rr          , Uu^Vud      , Xu          , Xu          , Xu          
Uu^Uf       , Rr          , Rr          , Rr          , Uu          , Uu          , Uu          , Uu          , Ql          , Ql          , Xu          , _off^_usr   , _off^_usr   , _off^_usr   , _off^_usr   , Xu          , Qlf         , Kud         , Cud         , Rr          , Ql          , Ql          , Uu^Vud      , Rr          , Ql          , Rr          , Ql          , Rr          , Uu^Vud      , Xu          , Xu          , Xu          
Rr          , Rr          , Rr          , Rr          , Uu^Vud      , Uu          , Uu          , Ql          , Xu          , Xu          , Xu          , _off^_usr   , _off^_usr   , _off^_usr   , _off^_usr   , Xu          , Xu          , Qlf         , Ql          , Ql          , Xu          , Xu          , Uu^Vud      , Rr          , Rr          , Rr          , Rr          , Rr          , Uu^Vud      , Xu          , Xu          , Xu          
Uu          , Uu          , Uu^Vud      , Rr          , Uu          , Uu          , Uu^Uf       , Xu          , Xu          , Xu          , _off^_usr   , _off^_usr   , _off^_usr   , _off^_usr   , _off^_usr   , Xu          , Xu          , Xu          , Xu          , Xu          , Xu          , Xu          , Uu^Vud      , Rr          , Rr          , Ql          , Rr          , Rr          , Rr          , Ql          , Uu^Vud      , Xu          
