border_size=1
usage=map

Rr          , Gg          , Gg          , Gg          , Gg          , Gg          , Gg          , Gs^Fp       , Gs^Fp       , Gg          , Gs^Fp       , Gs^Fp       , Gg          , Hh          , Hh          , Hh          , Hh          , Gs^Fp       , Gg          , Gs^Fp       , Ss          , Ss          , Gs^Fp       , Ss          , Re^Gvs      , Gg          , Re^Gvs      , Re^Gvs      , Re^Gvs      , Gg          , Ss          , Ss          , Gg          , Ss          , Gg          , Gg          
Gg          , Rr          , Rr          , Gg          , Gg          , Gg^Vh       , Gg          , Gs^Fdw      , Gs^Fmw      , Gg          , Gs^Fp       , Gs^Fp       , Gg          , Hh          , Hh          , Hh          , Hh          , Gs^Fp       , Gg          , Gs^Fp       , Ss          , Ss          , Gs^Fmw      , Ss          , Re^Gvs      , Gg          , Re^Gvs      , Re^Gvs      , Re^Gvs      , Gg          , Ss          , Ss          , Gg          , Ss          , Gg          , Gg          
Gg          , Gg          , Rr          , Gg          , Ce          , Gg          , 3 Gs        , Gs^Fp       , Gs^Fp       , Gs^Fmw      , Gg          , Gs          , Gs          , Hh          , Hh          , Gg          , Gs^Fdw      , Gs^Fmw      , Gs          , Gs^Fmw      , Ss          , Gs^Fmw      , Gs^Fdw      , Gs^Fdw      , Re^Gvs      , Re^Gvs      , Re^Gvs      , Re^Gvs      , Re^Gvs      , Ss          , Gg          , Gs^Fp       , Gg          , Ss          , Gs^Fp       , Gs^Fp       
Gg          , Gs          , Gs          , 1 Ke        , Ce          , Gg          , Gs          , Gs          , Gs^Fmw      , Gg          , Gs^Fp       , Gs          , Hh          , Hh          , Gs^Fp       , Gs^Fmw      , Gs^Fmw      , Gs^Fdw      , Gs          , Gs^Fp       , Re^Gvs      , Gg          , Re^Gvs      , Re^Gvs      , Re^Gvs      , Re^Gvs      , Ce          , Gg          , Gg          , Gg          , Gg          , Gg          , Ss          , Gs^Fdw      , Gg          , Gg          
Gg          , Gs          , Gg          , Ce          , Gg          , Gg          , Gg          , Gs^Fdw      , Gs^Fp       , Gg          , Gs          , Gg          , Gg          , Gs^Fmw      , Gg          , Gg          , Gg          , Gs^Fdw      , Gs^Fp       , Gs          , Gg          , Re^Gvs      , Re^Gvs      , Re^Gvs      , Ce          , Ce          , Gg^Vh       , Rd          , Ce          , Gg          , Gs          , Ss          , Gg          , Gs^Fmw      , Gs^Fmw      , Gs^Fp       
Gs^Fp       , Gs^Fp       , Gg          , Rd          , Rd          , Gs          , 4 Gs^Fmw    , Gg          , Gg^Vh       , Gg          , Gs^Fp       , Gs^Fp       , Gs^Fdw      , Gs^Fmw      , Gs^Fp       , Gs^Fp       , Rd          , Gg          , Gg          , Gg          , Rd          , Gs          , Gg          , Gg          , Rd          , Rd          , Rd          , Rd          , Ke          , Gs          , Gs          , Ss          , Ss          , Gg          , Gs          , Gs          
Gg          , Gg          , Gs^Fp       , 2 Gg        , Gg          , Rd          , Rd          , Gg          , Rd          , Gg          , Rd          , Gg          , Rd          , Rd          , Rd          , Rd          , Hh          , Rd          , Rd          , Rd          , Gs^Fdw      , Rd          , Rd          , Rd          , Ce          , Rd          , Gg^Vh       , Rd          , Ce          , Gg          , Ss          , Gg          , Ss          , Ss          , Gs          , Gg          
Gg          , Gg          , Gs^Fdw      , Gs^Fmw      , Gs^Fp       , Gs          , Hh          , Rd          , Gs^Fdw      , Rd          , Gg          , Rd          , Ds          , Ds          , Gg          , Gg          , Gg^Vh       , Hh          , Hh          , Gs^Fp       , Gs^Fdw      , Gs^Fdw      , Gg          , Gg          , Gg          , Ce          , Ce          , Rd          , Gg          , Gg          , Ww          , Gg          , Ss          , Gg          , Ss          , Ss          
Gg          , Gs          , Gg          , Gs^Fdw      , Gs^Fmw      , Hh          , Hh          , Hh          , Gs^Fmw      , Rd          , Gg          , Ds          , Ss          , Ss          , Ss          , Gg          , Ds          , Gg          , Gg          , Gs^Fp       , Gs^Fp       , Gs^Fp       , Ss          , Gg          , Ss          , Gg          , Ss          , Gg          , Gg          , Ss          , Ww          , Ss          , Ss          , Gg^Vh       , Ww          , Ww          
Gg          , Gg          , Gs^Fp       , Gg          , Hh^Vhh      , Hh          , Gs^Fmw      , Gs^Fp       , Rd          , Rd          , Ss          , Ss          , Ss          , Wo          , Ww          , Ss          , Ss          , Ds          , Ss          , Gs^Fp       , Ww          , Ww          , Ww          , Ss          , Gg^Vh       , Gg          , Ss          , Gg          , Ss          , Ss          , Ww          , Ww          , Ww          , Ww          , Gg          , Gg          
Gg          , Gs          , Gs^Fp       , Gs^Fmw      , Rd          , Gg          , Rd          , Rd          , Ds          , Ss          , Ss          , Ss          , Wo          , Ww          , Ss          , Ww          , Ww          , Ww          , Ww          , Ww          , Hh          , Hh          , Hh          , Ww          , Ww          , Ss          , Gg          , Gg          , Ww          , Ss          , Ss          , Ss          , Gg          , Ss          , Gs          , Gg          
Gg          , Gs          , Rd          , Rd          , Gs^Fmw      , Rd          , Gg          , Ds          , Ds          , Ss          , Wo          , Wo          , Wo          , Wo          , Ww          , Wo          , Wo          , Ds          , Ss          , Hh          , Hh          , Hh          , Ss          , Ss          , Ss          , Ww          , Ww          , Ww          , Ss          , Ss          , Ss          , Gg          , Ss          , Ss          , Gs          , Gs          
Gg          , Rd          , Ss          , Ss          , Gs^Fmw      , Gg          , Hh          , Gg          , Ss          , Ww          , Ww          , Wo          , Ss          , Ss^Vhs      , Wo          , Ww          , Wo          , Ds          , Ss          , Gg          , Gs          , Gg          , Gs          , Gs          , Ss          , Ss          , Ss          , Ss          , Ss          , Gg          , Gg          , Ss          , Gg          , Gg          , Gg          , Gg          
Gg          , Rd          , Ss          , Gs^Fdw      , Ss^Vhs      , Gs^Fp       , Hh          , Hh          , Gs^Fmw      , Ss          , Ss          , Ww          , Ww          , Wo          , Ww          , Ww          , Wo          , Ss          , Gg          , Gg          , Ss          , Ss          , Gs^Fp       , Gs^Fmw      , Gs^Fmw      , Ss          , Gs          , Gs          , Gs          , Ss          , Gs          , Gs^Fp       , Gg          , Hh          , Hh          , Hh          
Gg          , Rd          , Gs^Fmw      , Ss          , Gs^Fp       , Hh          , Hh          , Gs^Fmw      , Gg          , Ds          , Ds          , Ss          , Ss          , Ss          , Ss          , Ss          , Ss          , Ss          , Gg          , Gg          , Gg          , Ss          , Gg          , Gs^Fdw      , Gs^Fdw      , Ss          , Gs          , Ss          , Ss          , Ss          , Gs          , Gs^Fmw      , Hh          , Hh          , Gg          , Gg          
Gg          , Rd          , Gg          , Ss          , Gs^Fp       , Gs^Fmw      , Gs^Fmw      , Gs^Fdw      , Gg          , Gg          , Gs^Fp       , Ds          , Gs^Fp       , Ss          , Gg          , Ss          , Gs          , Gg          , Gg          , Gg          , Gg          , Gg          , Ss          , Gg          , Gs^Fp       , Gg          , Ss          , Gs          , Ss^Vhs      , Gg          , Gs^Fp       , Gs^Fdw      , Gs^Fp       , Hh          , Gs          , Gs          
Gg          , Rd          , Gs^Fp       , Gs^Fdw      , Gs          , Gg          , Ss          , Gg          , Ss          , Ss          , Gs^Fmw      , Gs^Fmw      , Ss          , Gg          , Ss          , Gs          , Gs          , Gs          , Hh          , Gg          , Hh          , Gg          , Gg          , Ss          , Ss          , Gs          , Gs          , Ss          , Ss          , Gg          , Gg          , Gg          , Hh          , Gg          , Gs          , Gs          
Gg          , Rd          , Rd          , Gg          , Rd          , Rd          , Rd          , Ss          , Gs^Fp       , Gg          , Gs          , Gg          , Gg          , Ss          , Gs          , Ss          , Gg          , Gg          , Hh          , Hh          , Hh          , Gg          , Hh          , Gg          , Gg          , Gg          , Gg          , Gg          , Gg          , Gg          , Gs^Fp       , Gg          , Gg          , Gg          , Gg          , Gs          
Gg          , Gg          , Hh          , Rd          , Gg          , Hh          , Rd          , Gg^Vh       , Gg          , Gs^Fmw      , Gs^Fp       , Ss          , Gs          , Ss          , Gs          , Gg          , Hh          , Gg          , Gg^Vh       , Mm          , Mm          , Mm          , Hh          , Gs          , Gg          , Ss          , Ss          , Ss          , Ss          , Ss          , Gg          , Gs^Fdw      , Gs^Fmw      , Ss          , Gg          , Gg          
Hh          , Hh          , Hh          , Gs          , Hh          , Rd          , Gs          , Rd          , Rd          , Gs^Fdw      , Gs^Fmw      , Ss          , Gs          , Ss          , Gg          , Gg          , Hh          , Gg          , Gg          , Hh          , Mm          , Mm          , Mm          , Gs          , Gg          , Gg          , Gg          , Gs          , Gs          , Gs          , Gg          , Gs^Fmw      , Ss          , Ss          , Ss          , Ss          
Gg          , Gg          , Gg          , Gg          , Ce          , Rd          , Ce          , Hh          , Gg          , Rd          , Gs^Fmw      , Gg          , Gg          , Ss          , Gg          , Hh          , Hh          , Mm          , Hh          , Hh          , Re^Gvs      , Mm          , Hh          , Gg          , Hh          , Hh          , Hh          , Hh          , Hh          , Hh          , Gg          , Gs^Fp       , Gg          , Ss          , Ss          , Ss          
Hh          , Hh          , Ce          , Ce          , Gg^Vh       , Rd          , Ke          , Hh          , Gg          , Rd          , Rd          , Gg          , Ss          , Ss          , Gg          , Hh          , Hh          , Mm          , Gg          , Re^Gvs      , Re^Gvs      , Re^Gvs      , Re^Gvs      , Gg          , Hh          , Mm          , Mm          , Hh          , Hh          , Hh          , Gs^Fmw      , Gg          , Gg          , Gg          , Gg          , Gg          
Ww          , Ww          , Ww          , Rd          , Rd          , Rd          , Ce          , Hh          , Gg          , Ss          , Ss          , Rd          , Rd          , Gg          , Gg          , Hh          , Gg          , Gg          , Ce          , Ce          , Gg^Vh       , Re^Gvs      , Gg          , Gg          , Re^Gvs      , Mm          , Mm          , Mm          , Hh          , Gg          , Gs^Fdw      , Gs^Fmw      , Ss          , Ss          , Gg          , Gg          
Hh          , Hh          , Ww          , Ce          , Ce          , Gg^Vh       , Gg          , Gg          , Gg          , Gg          , Gg^Vh       , Gg          , Gg          , Rd          , Rd          , Rd          , Rd          , Ce          , Gg^Vh       , Rd          , Rd          , Rd          , Gg          , Re^Gvs      , Re^Gvs      , Hh          , Mm          , Hh          , Hh          , Gg          , Ss          , Gs^Fp       , Ss          , Gg          , Ss          , Ss          
Hh          , Hh          , Ww          , Hh          , Hh          , Hh          , Gs          , Ss          , Ss          , Gg          , Ss          , Gg          , Gg          , Hh          , Re^Gvs      , Gg          , Ce          , Rd          , Rd          , Rd          , Rd          , Ke          , Ce          , Re^Gvs      , Ss          , Ss          , Hh          , Hh          , Gg          , Gg          , Ss          , Ss          , Ss          , Gg          , Ss          , Ss          
Gg          , Gg          , Ww          , Hh          , Hh          , Gg          , Gg          , Gg          , Gg          , Gg          , Ss          , Gg          , Hh          , Re^Gvs      , Re^Gvs      , Gg          , Gg          , Ce          , Ce          , Gg^Vh       , Ce          , Ce          , Gs          , Gg          , Hh          , Ww          , Ww          , Hh          , Gg          , Gg          , Gg          , Ss          , Gs^Fp       , Gg          , Ss          , Ss          
Ww          , Ww          , Hh          , Hh          , Gs          , Gg          , Gs^Fp       , Gg          , Gg          , Gg          , Gg          , Gg          , Hh          , Re^Gvs      , Re^Gvs      , Re^Gvs      , Re^Gvs      , Gg          , Gg          , Gg          , Gg          , Gs          , Gs          , Hh          , Hh          , Ss          , Ww          , Hh          , Ss          , Ss          , Ss          , Gg          , Gg          , Gs^Fdw      , Ss          , Ss          
Hh          , Hh          , Hh          , Gs          , Gs          , Gs^Fdw      , Gs          , Gs          , Gs          , Ss          , Ss          , Gg          , Gg          , Hh          , Gg          , Re^Gvs      , Re^Gvs      , Re^Gvs      , Hh          , Gg          , Gs^Fp       , Gg          , Hh          , Hh          , Hh          , Gg          , Ww          , Ss          , Ss          , Ss          , Ww          , Ss          , Ss          , Gs^Fp       , Ss          , Ss          
Hh          , Hh          , Hh          , Gg          , Gg          , Gs^Fmw      , Gg          , Gs          , Gs^Fp       , Gg          , Gg          , Gg          , Gg          , Gg^Vh       , Hh          , Hh          , Hh          , Hh          , Gg          , Gs^Fmw      , Gg          , Hh          , Gg          , Gg^Vh       , Ss          , Gg          , Gs          , Ww          , Ww          , Ss          , Ss          , Ss          , Gg          , Ss          , Ww          , Ww          
Hh          , Hh          , Hh          , Gg          , Gs^Fp       , Gs^Fdw      , Gs^Fmw      , Gg          , Gs^Fp       , Gg          , Ss          , Ss          , Gg          , Gg          , Hh          , Hh          , Ss          , Ss          , Ss          , Gs^Fp       , Ss          , Gg          , Ss          , Ss          , Ss          , Gs          , Gs          , Chr         , Chr         , Ww          , Ww          , Ww          , Ww          , Ww          , Gs          , Gg          
Hh          , Hh          , Hh          , Gs^Fmw      , Gg^Vh       , Gs^Fdw      , Gs^Fp       , Gs^Fmw      , Gg          , Ss          , Ss          , Gs          , Gg          , Hh          , Gs          , Gg          , Gg          , Gg          , Ss          , Ss          , Ww          , Gg          , Ww          , Gg          , Ss          , Gg          , Gg          , Chr         , Ww          , Ww          , Gg          , Ss          , Ss          , Ss          , Gg          , Gg          
Mm          , Mm          , Hh          , Gg          , Gg          , Gs          , Gg          , Gg          , Gs^Fdw      , Gg          , Ss          , Gg          , Gg          , Gs          , Gs          , Gg          , Ss          , Gg          , Gg          , Gg          , Ss          , Gg          , Gg          , Ww          , Gg          , Ww          , Ww          , Ww          , Gg          , Ss          , Gg          , Ww          , Gg          , Gs          , Ss          , Ss          
Mm          , Mm          , Hh          , Hh          , Hh          , Gs^Fmw      , Gs          , Gs^Fdw      , Gs^Fp       , Ss          , Gs          , Ss          , Ss          , Ss          , Gg          , Ss          , Ss          , Ww          , Ww          , Ss          , Ss          , Ss          , Ss          , Ss          , Ss          , Gg          , Ss          , Gg          , Gs          , Ss          , Ww          , Ww          , Ss          , Gg          , Ss          , Ss          
Mm          , Mm          , Mm          , Mm          , Gg          , Hh          , Gs          , Gs          , Gg          , Gg          , Gg          , Gg          , Ss          , Ss          , Gg          , Ss          , Gg          , Ss          , Ss          , Gg          , Gs          , Gg          , Ss          , Gg          , Gs          , Gs          , Gg          , Ss          , Ss          , Ss          , Gg          , Gs^Fp       , Gg          , Gg          , Ss          , Ss          
Mm          , Mm          , Mm          , Mm          , Gg          , Hh          , Gg          , Gg          , Gg          , Gg          , Gg          , Gg          , Ss          , Ss          , Gg          , Ss          , Gg          , Ss          , Ss          , Gg          , Gg          , Gg          , Ss          , Gg          , Gg          , Gs          , Gg          , Ss          , Ss          , Ss          , Gg          , Gs^Fp       , Gg          , Gg          , Ss          , Ss          
