border_size=1
usage=map

Gg          , Gg          , Gs^Fp       , Gg          , Hh          , Hh          , Gs^Fms      , Gg          , Gg          , Gg          , Gg          , Hh          , Gs^Fp       , Gg          , Gg          , Rr          , Gg          , Hh          , Gg          , Gs^Fp       , Gs^Fms      , Gs^Fp       , Gs^Fp       , Gg          , Gg          , Ww          , Ww          , Ww          , Gg          , Gs^Fp       , Gg          , Gg          
Gg          , Gg          , Gs^Fp       , Gs          , Hh          , Hh          , Gs^Fds      , Gs          , Gg          , Gg          , Gg          , Hh          , Gs^Fp       , Gg          , Rr          , Rr          , Gg          , Hh          , Gs          , Gs^Fms      , Gs^Fds      , Gs^Fds      , Gs^Fp       , Gg          , Gg          , Ww          , Ww          , Ww          , Gg          , Gs^Fms      , Gg          , Gg          
Gs^Fms      , Gs^Fms      , Gg          , Gs^Fp       , Gs^Fms      , Hh          , Gg          , Gs          , Gs^Fp       , Gs^Fms      , Gs^Fds      , Gs^Fms      , Hh          , Gg          , Rr          , Gg          , Gs^Fms      , Gs^Fp       , Gs          , Gs^Fp       , Gs          , Gs^Fms      , Gg          , Gg          , Ww          , Ww          , Gg          , Gg          , Gs^Fms      , Gs^Fds      , Gs^Fms      , Gs^Fp       
Gs^Fds      , Gs^Fds      , Gs          , Gg          , Gs^Fp       , Hh          , Hh          , Gs^Fp       , Gs^Fp       , Gg          , Gs          , Gs^Fp       , Gg          , Gg          , Rr          , Gg          , Gs^Fp       , Gs^Fp       , Gg          , Gs^Fp       , Gg          , Gg          , Ds          , Ds          , Ww          , Ww          , Ds          , Gg          , Gg          , Gs^Fds      , Gs^Fms      , Gs^Fp       
Gg          , Gg          , Gs          , Gs^Fp       , Gg          , Gg          , Gs^Fms      , Hh          , Gs          , Gs^Fp       , Gg          , Gg          , Gs^Fp       , Rr          , Gg          , Gg          , Hh          , Hh          , Gs^Fp       , Gs^Fms      , Gg          , Gg          , Ds          , Ds          , Ww          , Ds          , Gg          , Gg          , Gg          , Hh          , Gs^Fp       , Gs^Fp       
Gs          , Gs          , Gg          , Gs^Fp       , Gg          , Gg          , Gs^Fds      , Gs          , Gs          , Gg          , Gs^Fp       , Gg          , Rr          , Rr          , Gg^Gvs      , Gg          , Gg          , Gg          , Gg          , Gg          , Ds          , Ds          , Ds          , Ww          , Ww          , Gg          , Gg          , Gs^Fp       , Gs^Fp       , Gs^Fp       , Gg          , Gg          
Gg          , Gg          , Gs^Fds      , Gs          , Gs^Fms      , Gg          , Gg          , Gs^Fms      , Gs^Fms      , Hh          , Gg          , Gs^Fp       , Rr          , Gg^Gvs      , Gg^Gvs      , Gg^Gvs      , Ww          , Ww          , Ww          , Ww          , Ww          , Ww          , Ww          , Ww          , Gg          , Gg          , Hh          , Hh          , Gg          , Hh          , Gs^Fms      , Gs^Fp       
Gg          , Gs          , Hh          , Gs^Fds      , Gg          , Gs          , Gs^Fp       , Gs^Fms      , Gg          , Gs^Fp       , Gs^Fp       , Gg          , Rr          , Gg^Gvs      , Gg^Gvs      , Ww          , Ww          , Ww          , Ds          , Ww          , Gg          , Ww          , Ww          , Ww          , Gg          , Gg          , Gg          , Gg          , Gs^Fp       , Hh          , Gs^Fms      , Gs^Fp       
Gs^Fp       , Gs^Fp       , Gg          , Gs^Fms      , Gg          , Gs^Fp       , Gg          , Gs^Fp       , Gg          , Hh          , Gs^Fp       , Gg          , Rr          , Gg          , Ce          , Ww          , Ww          , Ds          , Gg          , Gg          , Gg          , Gg^Vh       , Gg          , Gg          , Gg          , Gg          , Gg          , Gs^Fp       , Gs^Fp       , Gg          , Gs^Fp       , Gs^Fp       
Gg          , Gg          , Gs^Fp       , Gg          , Gg          , Hh          , Hh          , Gs^Fp       , Gg          , Gs^Fp       , Gg          , Gg          , Rr          , Ce          , Gg^Vh       , Gg          , Ww          , Ke          , Ce          , Gg          , Hh          , Gg          , Gg          , Gs^Fp       , Gg          , Hh          , Hh          , Gs^Fp       , Gg          , Gs          , Gs^Fms      , Gs^Fp       
Gg          , Gg          , Gs^Fp       , Gs          , Hh          , Gs^Fp       , Gs^Fp       , Gs          , Gg          , Gs^Fp       , Gg          , Ce          , Gg^Vh       , Rr          , Gg          , Ww          , Ww          , Gg^Vh       , Ce          , Hh          , Hh          , Gg          , Gg          , Gs^Fms      , Gg          , Gs          , Gs^Fp       , Gg          , Gg          , Gs^Fds      , Gs          , Gg          
Gg          , Gg          , Gg          , Gs          , Gg          , Gs^Fp       , Gg          , Gg          , Gg          , Gg          , Gg          , Ce          , Gg          , Rr          , Ww^Bw\      , Ww          , Gg^Vh       , Gg          , Ce          , Gg          , Gg^Gvs      , Gg          , Gg          , Gs^Fds      , Gs^Fms      , Gs^Fms      , Hh          , Gg          , Gg          , Gs^Fms      , Rr          , Rr          
Gg^Gvs      , Gg^Gvs      , Gg^Gvs      , Gs^Fp       , Gg          , Gg          , Gg          , Gg          , Ww          , Gg          , Ww          , Ww          , Ww          , Ww          , Gg          , Rr          , Rr          , Gg          , Ce          , Gg          , Gg^Gvs      , Gg^Gvs      , Gg^Gvs      , Hh          , Gg          , Hh          , Gg          , Gg          , Rr          , Rr          , Gg^Vh       , Gg          
Gg^Gvs      , Gg^Gvs      , Gg^Gvs      , Gg^Vh       , Gg          , Gs          , Ww          , Ww          , Ww          , Ww          , Ww          , Ww          , Ce          , Gg          , Gg          , Gg^Vh       , Rr          , Gg          , Ce          , Gg          , Gg          , Gg^Gvs      , Gg          , Gg          , Gg          , Gg          , Gg          , Rr          , Gg          , Gg          , Gg          , Gg          
Gg^Gvs      , Gg^Gvs      , Gs          , Gg          , Ww          , Ww          , Ww          , Ww          , Ds          , Ww          , Gg          , Gg          , Hh          , Ce          , Ce          , Gg          , Ce          , Rr          , Rr          , Rr          , Rr          , Gs^Fp       , Rr          , Rr          , Rr          , Rr          , Rr          , Rr          , Gs^Fp       , Gs^Fms      , Gs^Fp       , Gs^Fp       
Gg          , Gg          , Gg          , Gs          , Ww          , Ww          , Gg          , Gg          , Gg          , Ds          , Gs^Fms      , Hh          , Gs^Fms      , Gg          , Gg          , Ce          , Rr          , 2 Rr        , Gg          , Gg          , Gg          , Rr          , Gg          , Gg          , Gg          , Gg          , Gg          , Gs^Fp       , Gs          , Gs^Fds      , Gs^Fms      , Gs^Fp       
Gg          , Gg          , Ww          , Ww          , Ww          , Ww          , Ds          , Gs^Fp       , Gs          , Gg          , Gg          , Hh          , Gg          , Gg          , Gg          , Gg          , Rr          , Gg          , Gs^Fp       , Gs^Fms      , Gg          , Gg          , Gs^Fp       , Gg          , Gs^Fp       , Gg          , Gg          , Gs^Fp       , Gg          , Gg          , Gs          , Gs          
Gg          , Gs          , Gs          , Gg          , Ww          , Ww          , Ww          , Ww          , Ww          , Gg          , Gg          , Hh          , Gg          , Gg          , Gg          , Gg          , Rr          , Gg          , Gg          , Gg          , Gg          , Gg          , Hh          , Gs^Fp       , Hh          , Gs^Fp       , Gg          , Gg          , Gg          , Gs^Fp       , Gg          , Gg          
Gs^Fp       , Gs^Fp       , Gg          , Ss          , Ss          , Ss          , Gg          , Ww          , Ds          , Ss          , Ss          , Gs          , Gg          , Hh          , Gg          , Gg          , 1 Rr        , Gg          , Gg^Gvs      , Gg^Gvs      , Gg          , Gg^Vh       , Hh          , Hh          , Gg          , Gg          , Gg          , Gg          , Gg          , Gs^Fp       , Gg          , Gg          
Gg          , Gs          , Gs          , Ss          , Ss          , Ww          , Gs^Fp       , Ww          , Gs          , Ww          , Gg          , Gg          , Gg          , Hh          , Hh          , Gg          , Rr          , Gg          , Gg^Gvs      , Gg^Gvs      , Gg          , Hh          , Gg          , Gg          , Gg          , Hh          , Hh          , Hh          , Hh          , Gg          , Gs          , Gg          
Gs          , Gs          , Ww          , Gg          , Gs          , Ss          , Ss          , Ww          , Ww          , Gs          , Ww          , Gg          , Gs          , Hh          , Hh          , Gg          , Gg          , Rr          , Gg          , Gg^Gvs      , Gg^Gvs      , Gg          , Gg^Gvs      , Gg^Gvs      , Gg          , Hh          , Hh          , Gg          , Gg          , Gs^Fms      , Gs^Fds      , Gs^Fp       
Gg          , Gg          , Ss          , Ss          , Ss          , Gg          , Ww          , Ds          , Ss^Vhs      , Ss          , Ss          , Gs          , Gg          , Gg          , Gg          , Gg          , Gg^Vh       , Rr          , Gg          , Gg^Gvs      , Gg^Gvs      , Gg^Gvs      , Gg^Gvs      , Gg^Gvs      , Gg^Gvs      , Gg          , Gg          , Hh          , Gg          , Gg          , Gs^Fms      , Gs^Fp       
Ss          , Ss          , Gg          , Gg          , Gg          , Ww          , Gg          , Ww          , Gg          , Gg          , Gg          , Gs          , Ss          , Gg          , Gg          , Gg          , Rr          , Rr          , Gg          , Gg^Gvs      , Gg^Gvs      , Gg^Gvs      , Gg^Gvs      , Gg^Gvs      , Gg^Gvs      , Gg          , Gg          , Gg^Vh       , Gg          , Gs^Fms      , Gs          , Gg          
Ss          , Ss          , Ss          , Gg          , Ww          , Ds          , Gg          , Ww          , Ss          , Ss          , Ss          , Ss          , Ss          , Gg          , Gg          , Gg          , Rr          , Gg          , Gg^Gvs      , Gg^Gvs      , Gg^Gvs      , Gg^Gvs      , Gg^Gvs      , Gg^Gvs      , Gg^Gvs      , Gg^Gvs      , Gg^Gvs      , Gg          , Gg          , Gs^Fp       , Gg          , Gg          
Gg          , Gs          , Gs          , Ss          , Ww          , Gg          , Gg          , Ww          , Ss          , Ww          , Ww          , Ss          , Ss          , Gs          , Gs          , Gg          , Rr          , Gg          , Gg          , Gg^Gvs      , Gg^Gvs      , Gg^Gvs      , Gg          , Gg          , Gg          , Gg          , Gg          , Gg^Gvs      , Gg          , Gg          , Gg          , Gg          
Gg          , Gg          , Ss          , Ww          , Ww          , Ss          , Ss          , Ww          , Ww          , Ss          , Ds          , Gg          , Ww          , Gs          , Gg          , Gg          , Gg          , Rr          , Gg          , Gg^Gvs      , Gg          , Gg^Gvs      , Gg          , Hh          , Hh          , Hh          , Gg          , Gg^Gvs      , Gg          , Hh          , Hh^Vhh      , Hh          
Ss          , Ss          , Gg          , Ss          , Ww          , Ss          , Ss          , Ss          , Gg          , Ww          , Gs          , Ss          , Ww          , Ss          , Ww          , Gg          , Gg          , Rr          , Rr          , Gg          , Gg          , Gg          , Gg          , Gg          , Gg          , Gg          , Gg^Gvs      , Gg^Gvs      , Gg          , Hh          , Gg          , Gg          
Ss          , Ss          , Ss^Vhs      , Ww          , Ss          , Ww          , Gs          , Ds          , Ww          , Ww          , Gg          , Gg          , Ss          , Ss          , Ss          , Gg          , Gs          , Gg          , Ss^Vhs      , Rr          , Rr          , Rr          , Rr          , Gg          , Ce          , Gg          , Gg^Gvs      , Gg^Gvs      , Gg          , Hh          , Gg          , Gg          
Ss          , Ss          , Gs          , Gg          , Ss          , Ss          , Gg          , Ww          , Ss          , Ss          , Ww          , Ww          , Ww          , Ww          , Ww          , Ss          , Ss          , Gg          , Ss          , Gg          , Gg          , Gg          , Gg          , Rr          , Ce          , Ke          , Gg          , Gg^Gvs      , Gg^Gvs      , Gg          , Gg^Gvs      , Gg          
Ss          , Ss          , Gs          , Gs          , Ss          , Gg          , Ss          , Ss          , Gs          , Hh          , Hh          , Gg          , Hh          , Gg          , Gg          , Ww          , Ww          , Ss          , Gg          , Ww          , Gg          , Gg          , Gg          , Rr          , Rr          , Ce          , Ce          , Gg          , Gg^Gvs      , Gg^Gvs      , Gg^Gvs      , Gg          
Ss          , Ss          , Gg          , Gg          , Ss          , Ss          , Ss          , Ss          , Gg          , Gs          , Gg          , Hh          , Gg          , Hh          , Ss^Vhs      , Ww          , Ww          , Ss          , Ss          , Ww          , Ss          , Gg          , Gg          , Gg          , Rr          , Gg          , Gg          , Gg          , Gg          , Gg^Gvs      , Gg^Gvs      , Gg          
Ss          , Ss          , Gg          , Gg          , Ss          , Ss          , Ss          , Ss          , Gg          , Gg          , Gg          , Hh          , Gg          , Hh          , Ss          , Ww          , Ww          , Ss          , Ss          , Ww          , Ss          , Gg          , Gg          , Gg          , Rr          , Gg          , Gg          , Gg          , Gg          , Gg          , Gg          , Gg          
