border_size=1
usage=map

Gs^Fdf      , Gs^Fdf      , Gs^Fdf      , Rd          , Rd          , Re          , Gs^Fdf      , Gs^Fdf      , Gg          , Gs^Fdf      , Gs^Fdf      , Re          , Rd          , Rd          , Gs^Fdf      , Gs^Fdf      , Gg          , Wwf         , Wwf         , Gg          , Gs^Fdf      , Gs^Fdf      
Gs^Fdf      , Gs^Fdf      , Gs^Fdf      , Rd          , Rd          , Re          , Gs^Fdf      , Gs^Fdf      , Gg          , Gs^Fdf      , Gs^Fdf      , Re          , Rd          , Rd          , Gs^Fdf      , Gs^Fdf      , Gg          , Wwf         , Wwf         , Gg          , Gs^Fdf      , Gs^Fdf      
Gs^Fdf      , Gs^Fdf      , Re          , Re          , Gs^Fdf      , Rd          , Rd          , Gs^Fdf      , Gs^Fdf      , Gs^Fdf      , Rd          , Rd          , Gs^Fdf      , Re          , Re          , Gs^Fdf      , Gs^Fdf      , Gg          , Gs^Fdf      , Gs^Fdf      , Re          , Re          
Re          , Re          , Gs^Fdf      , Gs^Fdf      , Gg          , Gs^Fdf      , Gs^Fdf      , Ce          , Ce          , Ce          , Gs^Fdf      , Gs^Fdf      , Gg          , Gs^Fdf      , Gs^Fdf      , Re          , Re          , Gs^Fdf      , Re          , Re          , Gs^Fdf      , Gs^Fdf      
Re          , Re          , Re          , Gs^Fdf      , Gs^Fdf      , Gs^Fdf      , Rd          , 1 Ke        , Gs^Fdf      , Ce          , Rd          , Gs^Fdf      , Gs^Fdf      , Gg          , Gs^Fdf      , Gs^Fdf      , Re          , Re          , Re          , Gs^Fdf      , Gs^Fdf      , Gs^Fdf      
Gs^Fdf      , Gs^Fdf      , Gs^Fdf      , Re          , Rd          , Rd          , Gs^Fdf      , Gs^Fdf      , Wwf         , Gs^Fdf      , Gs^Fdf      , Rd          , Rd          , Gs^Fdf      , Re          , Re          , Gs^Fdf      , Gs^Fdf      , Gs^Fdf      , Re          , Re          , Re          
Gs^Fdf      , Gs^Fdf      , Rd          , Rd          , Gs^Fdf      , Gs^Fdf      , Ww^Bw\      , Wwf         , Ww^Bw\      , Wwf         , Ww^Bw/      , Gs^Fdf      , Gs^Fdf      , Rd          , Rd          , Gs^Fdf      , Gs^Fdf      , Gg          , Gg          , Gs^Fdf      , Gs^Fdf      , Gs^Fdf      
Rd          , Rd          , Gs^Fdf      , Gs^Fdf      , Ww^Bw/      , Ww^Bw/      , Ww          , Ww^Bw/      , Ww          , Ww^Bw\      , Ww          , Ww^Bw\      , Ww^Bw\      , Gs^Fdf      , Gs^Fdf      , Rd          , Rd          , Gs^Fdf      , Gs^Fdf      , Gg          , Gg          , Gg          
Gs^Fdf      , Gs^Fdf      , Ww^Bw/      , Ww^Bw/      , Ww          , Ww          , Ww          , Ww          , Wo          , Ww          , Ww          , Ww          , Ww          , Ww^Bw\      , Ww^Bw\      , Gs^Fdf      , Gs^Fdf      , Rd          , Rd          , Gs^Fdf      , Gs^Fdf      , Gs^Fdf      
Ww^Bw/      , Ww^Bw/      , Ww          , Ww          , Ww          , Ww          , Wo          , Wo          , Wo          , Wo          , Wo          , Ww          , Ww          , Ww          , Ww          , Ww^Bw\      , Ww^Bw\      , Gs^Fdf      , Gs^Fdf      , Rd          , Rd          , Rd          
Ww          , Ww          , Ww          , Ww          , Ww          , Ww          , Wo          , Wo          , Wo          , Wo          , Wo          , Wo          , Ww          , Ww          , Ww          , Ww          , Ww          , Ww^Bw\      , Ww^Bw\      , Gs^Fdf      , Gs^Fdf      , Gs^Fdf      
Ww          , Ww          , Wo          , Ww          , Wo          , Ww          , Wo          , Wo          , Wo          , Wo          , Wo          , Wo          , Wo          , Ww          , Wo          , Ww          , Ww          , Ww          , Ww          , Ww^Bw\      , Ww^Bw\      , Ww^Bw\      
Wo          , Wo          , Wo          , Wo          , Wo          , Wo          , Wo          , Wo          , Wo          , Wo          , Wo          , Wo          , Wo          , Wo          , Wo          , Wo          , Wo          , Ww          , Ww          , Ww          , Ww          , Ww          
Wo          , Wo          , Wo          , Wo          , Wo          , Wo          , Wo          , Wo          , Wo          , Wo          , Wo          , Wo          , Wo          , Wo          , Wo          , Wo          , Wo          , Ww          , Ww          , Ww          , Ww          , Ww          
Wo          , Wo          , Wo          , Wo          , Wo          , Wo          , Wo          , Wo          , Wo          , Wo          , Wo          , Wo          , Wo          , Wo          , Wo          , Wo          , Wo          , Ww          , Ww          , Ww          , Ww          , Ww          
Wo          , Wo          , Wo          , Wo          , Wo          , Wo          , Wo          , Wo          , Wo          , Wo          , Wo          , Wo          , Wo          , Wo          , Wo          , Wo          , Wo          , Wo          , Wo          , Wo          , Ww          , Ww          
Wo          , Wo          , Wo          , Wo          , Wo          , Wo          , Wo          , Wo          , Wo          , Wo          , Wo          , Wo          , Wo          , Wo          , Wo          , Wo          , Wo          , Wo          , Wo          , Wo          , Ww          , Ww          
Wo          , Wo          , Wo          , Wo          , Wo          , Wo          , Wo          , Wo          , Wo          , Wo          , Wo          , Wo          , Wo          , Wo          , Wo          , Wo          , Wo          , Wo          , Wo          , Wo          , Wo          , Wo          
Wo          , Wo          , Wo          , Wo          , Wo          , Wo          , Wo          , Wo          , Wo          , Wo          , Wo          , Wo          , Wo          , Wo          , Wo          , Wo          , Wo          , Wo          , Wo          , Wo          , Wo          , Wo          
Wo          , Wo          , Wo          , Wo          , Wo          , Wo          , Wo          , Wo          , Wo          , Wo          , Wo          , Wo          , Wo          , Wo          , Wo          , Wo          , Wo          , Wo          , Wo          , Wo          , Wo          , Wo          
Wo          , Wo          , Wo          , Wo          , Wo          , Wo          , Wo          , Wo          , Wo          , Wo          , Wo          , Wo          , Wo          , Wo          , Wo          , Wo          , Wo          , Wo          , Wo          , Wo          , Wo          , Wo          
