Gs^Fp, Gs^Fp, Gg, Gg, Gg, Gg, Gg, Gs^Fp, Gg, Gg, Gg, Rr, Gg, Gg, Gg, Gg, Ww, Ww, Gs^Fp, Gg, Gg, Gg, Gs^Fp, Gg, Gg, Gg, Gg, Gg, Gs^Fp, Gs^Fp, Gg, Gg, Gg, Gg
Gs^Fp, Gs^Fp, Gg, Gg, Gg, Gg, Gg, Gs^Fp, Gg, Gg, Gg, Rr, Gg, Gg, Gg^Vh, Gg, Gg, Ww, Gs^Fp, Gg, Gg, Gg, Gs^Fp, Gg, Gg, Gg, Gg, Gg, Gs^Fp, Gs^Fp, Gg, Gg, Gg, Gg
Gg, Gg, Gg, Gs^Fp, Gs^Fp, Gs^Fp, Ce, Gg, Gg, Gg, Ce, Ce, Ce, Gg, Gg, Gg, Gg, Ww, Gs^Fp, Gs^Fp, Gg, Gg, Gs^Fp, Gg, Gg, Gs^Fp, Gg, Gs^Fp, Gg, Gg, Gg, Gs^Fp, Gs^Fp, Gs^Fp
Gg, Gg, Gs^Fp, Gs^Fp, Gs^Fp, Gg, Ce, Gg, Gg^Vh, Gg, Gg, 1 Ke, Ce, Gg, Gg, Gg, Gg, Ww, Ww, Gs^Fp, Gs^Fp, Gg, Gg, Gs^Fp, Gs^Fp, Gs^Fp, Gg^Vh, Gg, Gs^Fp, Gg, Gg, Gg, Gs^Fp, Gs^Fp
Gs^Fp, Gs^Fp, Gg, Gs^Fp, Gg, Gg, Ce, Gg, Gg, Gg, Gg, Ce, Ce, Gg, Gg, Gg^Vh, Gg, Ce, Gg, Ww, Ww, Gg, Gg, Gg, Gs^Fp, Gg, Gg, Gs^Fp, Gs^Fp, Gg, Gs^Fp, Gg, Gs^Fp, Gs^Fp
Gg, Gg, Gg, Gg, Gs^Fp, Gg, Ce, Gg, Gg, Gg, Gg, Rr, Gg, Gg, Gg, Gg, Gg, Ce, Gg, Hh, Gg, Ww, Ww, Gg, Gg, Gg, Gg, Gs^Fp, Gg, Gs^Fp, Gs^Fp, Gg, Gs^Fp, Gs^Fp
Gg, Gg, Gg, Gs^Fp, Gs^Fp, Gs^Fp, Ce, Gg, Gg, Gg^Vh, Gg, Rr, Gg, Gg, Gg, Gg, Gg, Ce, Hh, Hh, Hh, Gg, Ww, Gg, Gg, Gg, Gg, Gg, Gg, Gg, Gg, Gg, Gg, Gg
Gg, Gg, Gg, Gs^Fp, Gg, Gg, Gg, Ce, Ce, Gg, Gg, Rr, Gg, Gg^Vh, Gg, Gg, Ce, Hh, Hh, Hh, Hh, Gg, Gg, Ww, Ww, Gg, Gg, Gg, Gg, Gs^Fp, Gs^Fp, Gg, Gg, Gg
Gg, Gg, Gs^Fp, Gg, Gg, Gg, Gg, Gg, Gg, Ce, Hh, Rr, Gg, Gg, Ce, Ce, Gg, Hh, Gg, Gg, Gg, Gg, Gg, Gg, Hh, Ww, Ww, Gs^Fp, Gs^Fp, Gs^Fp, Gg, Gg, Gg, Gg
Gg, Gg, Gs^Fp, Gs^Fp, Gg^Vh, Gg, Gg, Gg, Gg, Hh, Hh, Rr, Hh, Hh, Gg, Gg, Gg, Gg, Gg, Gg, Gs^Fp, Gg, Hh, Hh, Hh, Gg, Gg, Ww, Gg, Gs^Fp, Gg, Gg, Gg, Gg
Gg, Gg, Gs^Fp, Gs^Fp, Gg, Gg, Gg, Gg, Gg, Gg, Hh, Rr, Hh, Gg, Gg, Gg, Gg, Gg, Gs^Fp, Gs^Fp, Gs^Fp, Gg, Hh, Hh, Gg, Gg, Gg, Ww, Gg, Gg, Gg, Gg, Gg, Gg
Gg, Gg, Gg, Gg, Gg, Gg, Gg, Gg, Gg, Gg, Gg, Rr, Gg, Gg, Gg, Gg, Gg, Gg, Gg, Gg, Gg, Hh, Gg, Hh, Hh, Gg, Gg, Ww, Ww, Gg, Gg, Gg, Hh, Hh
Gg, Gg, Gg, Gg, Gg, Gg, Gg, Gg, Gg, Gg, Gg, Rr, Gg, Gg, Gg, Gg, Gg, Gg, Gs^Fp, Gg, Gs^Fp, Gs^Fp, Gg, Gg, Gg, Gg, Gg, Gg, Ww, Gg, Gg, Hh, Hh, Hh
Gg, Gg, Gg, Gg, Gg, Gg, Gg, Gg, Gll^Fp, Gg, Gg, Rr, Gg, Gg, Gg, Gg, Gg, Gg, Gg, Gs^Fp, Gs^Fp, Gs^Fp, Gg, Gg, Gs^Fp, Gs^Fp, Gg, Gg, Gg, Ww, Ww, Gg, Hh, Hh
Gg, Gg, Gg, Gg, Gg, Gg, Gg, Gll^Fp, Gg, Gg, Gg, Rr, Gg, Gg, Gg, Hh, Hh, Gg, Gg, Gg, Gg^Vh, Gs^Fp, Gg, Gg, Gg, Gg, Gg, Gg, Gg, Gg, Ww, Gg, Gg, Gg
Gg, Gg, Gg, Gg, Gg, Gg, Hh, Gg, Gg, Gg, Gg, Rr, Gg, Gg, Hh, Hh, Hh, Gg, Gg, Gg, Gg, Gg, Hh, Gg, Hh, Gg, Gg, Gg, Gg, Gg, Ww, Gg, Gg, Gg
Gg, Gg, Gg, Gg, Gg, Hh, Hh, Hh, Gg, Gg, Gg, Rr, Gg, Gg, Hh, Hh, Hh, Gg, Gg, Gg, Gg, Gg, Gg, Hh, Hh, Gg, Gg, Gg, Gg, Ww, Gg, Gg, Gg, Gg
Gg, Gg, Gg, Gg, Gg, Hh, Hh, Hh, Gg, Gg, Gg, Rr, Gg, Gg, Gg, Gll^Fp, Gg, Gg, Gg, Gg, Gg, Gg, Hh, Hh, Hh, Gg, Gg, Gg, Ww, Ww, Gg, Gg, Gg, Gg
Gg, Gg, Gg, Gg, Gg, Gg, Hh, Gg, Gg, Gll^Fp, Gg, Rr, Gg, Gg, Gg, Gg, Gg, Gg, Gg, Gg, Gg, Gg, Gg, Gg, Gg, Gg, Gg, Ww, Gg, Gg, Gg, Gg, Gg, Gg
Gg, Gg, Gg, Gg, Gg, Gg, Gg, Gg, Gg, Gg, Gg, Rr, Gg, Gg, Gg, Gg, Gg, Gg, Gg, Gg, Gg, Gg, Gg, Gg, Gg, Gg, Gg, Ww, Ww, Gg, Gg, Gg, Ww, Ww
Gg, Gg, Hh, Hh, Gg^Vh, Gg, Gg, Gg, Gg, Gg, Gg, Rr, Hh, Gg, Gll^Fp, Gg, Gg, Gg, Gg, Gg, Gg, Gg, Gg, Gg, Gg, Gg, Ww, Ww, Ww, Ww, Ww, Ww, Ww, Ww
Gg, Gg, Hh, Hh, Hh, Gg, Gg, Gg, Gg, Gg, Hh, Rr, Hh, Hh, Gg, Gg, Gg, Gg, Gg, Gg, Gg, Gg, Gg, Gg, Ww, Ww, Wo, Ww, Ww, Wo, Wo, Wo, Ww, Ww
Hh, Hh, Gg, Hh, Gg, Gll^Fp, Gg, Gg, Gg, Gg, Gg, Rr, Hh, Gg, Gg, Gg, Gg, Gg, Gg, Gg, Gg, Gg, Ww, Ww, Wo, Wo, Ww, Ww, Ww, Wo, Ww, Ww, Ww, Ww
Gg, Gg, Gg, Hh, Gg, Gg, Gg, Gg, Gg, Gg, Gg, Rr, Gg, Gg, Gg, Gg, Gg, Gg, Gg, Gg, Dd, Dd, Ww, Ww, Ww, Ww, Dd, Gg, Gg, Ww, Gg, Gg, Gg, Gg
Gg, Gg, Gg, Gg, Gg, Gg, Gg, Gg, Gg, Gg, Gg, Rr, Gg, Gg, Gg, Gg, Gg, Gg, Dd, Dd, Ww, Ww, Wo, Wo, Ww, Ss, Dd, Dd, Gg, Gg, Gg, Gg, Rr, Rr
Gg, Gg, Gg, Gg, Gg, Gg, Gg, Gg, Gg, Gg, Gg, Rr, Gg, Gg, Dd, Gg, Dd, Dd, Ww, Ww, Wo, Wo, Ww, Ww, Ss, Ss, Ss, Dd, Dd, Gg, Rr, Rr, Gg, Gg
Gg, Gg, Gg, Gg, Gg, Gg, Gg, Gg, Gg, Gg, Dd, Rr, Dd, Dd, Ss, Dd, Ww, Ww, Wo, Ww, Ww, Ww, Gg^Vh, Ss, Gg, Ch, Ch, Ss, Rr, Rr, Dd, Gg, Gg, Gg
Rr, Rr, Rr, Gg, Gg, Gg, Gg, Gg, Gg, Dd, Dd, Rr, Ss, Ss, Ch, Ss, Ww, Ww, Ww, Ww, Gg, Gg^Vh, Gg, Gg, Gg^Vh, Gg^Vh, Rr, Kh, Ss, Dd, Dd, Gg, Gg, Gg
Gg, Gg, Gg, Rr, Rr, Gg, Gg, Gg, Dd, Dd, Ss, Rr, Ch, Ch, Rr, Ch, Ww, Wo, Ww, Ww, Dd, Gg^Vh, Dd, Dd, Rr, Rr, Gg^Vh, Ch, Ss, Dd, Dd, Gg, Gg, Gg
Gg, Gg, Gg, Gg, Gg, Rr, Rr, Dd, Ss, Ss, Ch, Ch, Rr, Rr, Kh, Rr, Ww, Wo, Ww, Gg^Vh, Rr, Rr, Rr, Hh^Vhh, Rr, Dd, Gg, Ch, Ss, Dd, Dd, Gg, Gg, Gg
Gg, Gg, Gg, Gg, Gg, Dd, Dd, Rr, Ch, Ch, Rr, Rr, Kh, Kh, Gg^Vh, Kh, Ww, Ww, Ww^Bw/, Rr, Dd, Hh^Vhh, Gg^Vh, Rr, Rr, Gg^Vh, Gg^Vh, Ch, Ss, Dd, Dd, Gg, Gg, Gg
Gg, Gg, Gg, Gg, Gg, Gg, Dd, Ss, Ch, Rr, Kh, Kh, Rr, Dd, Gg, Gg^Vh, Rr, Ww^Bw/, Ww, Ww, Dd, Gg^Vh, Dd, Gg, Gg^Vh, Rr, Gg^Vh, Ch, Ss, Dd, Gg, Gg, Gg, Gg
Gg, Gg, Gg, Gg, Gg, Dd, Dd, Ss, Ch, Rr, Kh, Gg^Vh, Gg, Rr, Rr, Rr, Dd, Ww, Wo, Ww, Ww, Dd, Gg, Hh^Vhh, Gg, Rr, Gg, Ch, Ss, Dd, Gg, Gg, Gg, Gg
Gg, Gg, Gg, Gg, Gg, Dd, Ww, Ss, Ch, Rr, Kh, Dd, Hh^Vhh, Dd, Rr, Hh^Vhh, Ww, Ww, Wo, Ww, Gg^Vh, Gg^Vh, Gg, Dd, Gg^Vh, Rr, Gg^Vh, Ch, Ss, Dd, Gg, Gg, Gg, Gg
Gg, Gg, Gg, Gg, Ww, Ww, Ww, Ww, Ww, Rr, Ww, Gg, Gg^Vh, Dd, Dd, Rr, Ww^Bw\, Ww, Ww, Ww, Kh, Gg^Vh, Gg^Vh, Gg^Vh, Hh^Vhh, Rr, Dd, Ch, Ss, Dd, Gg, Gg, Gg, Gg
Gg, Gg, Ww, Ww, Wo, Wo, Wo, Wo, Ww, Ww, Ww, Ww, Ww, Ww, Ww, Ww, Ww, Ww^Bw\, Rr, Dd, Dd, Kh, Kh, Gg^Vh, Gg^Vh, Rr, Dd, Ch, Ss, Dd, Gg, Gg, Gg, Gg
Ww, Ww, Wo, Wo, Ww, Ww, Ww, Ww, Ww, Wo, Wo, Wo, Wo, Wo, Ww, Ww, Ww, Ww, Gg, 3 Rr, 2 Rr, Gg^Ve, Dd, Kh, Dd, Rr, Gg^Vh, Ch, Ss, Dd, Gg, Gg, Gg, Gg
Ww, Ww, Ww, Ww, Gg, Dd, Dd, Ss, Ch, Ww, Ww, Ww, Ww, Ww, Dd, Ww, Kh, Dd, Gg^Ve, Rr, Rr, Rr, Gg^Ve, Kh, Dd, Rr, Gg, Ch, Ss, Dd, Dd, Gg, Gg, Gg
Ww, Ww, Gg, Gg, Gg, Dd, Dd, Ss, Ch, Gg^Vh, Dd, Gg, Gg^Vh, Dd, Hh^Vhh, Gg^Vh, Gg^Vh, Kh, Kh, Dd, Gg^Ve, Gg^Ve, Kh, Kh, Gg^Vh, Rr, Gg^Vh, Ch, Ss, Dd, Gg, Gg, Gg, Gg
Gg, Gg, Gg, Gg, Gg, Dd, Dd, Ss, Ch, Gg^Vh, Rr, Hh^Vhh, Rr, Gg, Gg^Vh, Dd, Dd, Dd, Gg^Vh, Kh, Kh, Kh, Dd, Gg^Vh, Rr, Rr, Rr, Ch, Ss, Dd, Gg, Gg, Gg, Gg
Gg, Gg, Gg, Gg, Gg, Dd, Dd, Ss, Kh, Rr, Gg^Vh, Rr, Dd, Rr, Rr, Gg, Hh^Vhh, Gg^Vh, Hh^Vhh, Dd, Dd, Gg^Vh, Rr, Rr, Gg^Vh, Gg^Vh, Ch, Kh, Rr, Dd, Gg, Gg, Gg, Gg
Gg, Gg, Gg, Hh, Hh, Gg, Rr, Rr, Ss, Ch, Ch, Gg^Vh, Dd, Dd, Dd, Rr, Rr, Rr, Rr, Rr, Rr, Rr, Gg^Vh, Dd, Ch, Ch, Ss, Ss, Dd, Rr, Rr, Gg, Rr, Rr
Gg, Gg, Hh, Hh, Rr, Rr, Gg, Dd, Dd, Ss, Ss, Ch, Ch, Gg^Vh, Gg^Vh, Gg^Vh, Rr, Dd, Gg^Vh, Gg, Gg^Vh, Dd, Ch, Ch, Ss, Ss, Dd, Dd, Dd, Gg, Gg, Rr, Gg, Gg
Gg, Gg, Rr, Rr, Gg, Hh, Gg, Dd, Gg, Dd, Dd, Ss, Ss, Ch, Ch, Ch, Kh, Ch, Ch, Ch, Ch, Ch, Ss, Ss, Dd, Dd, Gg, Gg, Gg, Gg, Gg, Gg, Gg, Gg
Rr, Rr, Gg, Gg, Gg, Gg, Gg, Gg, Gg, Gg, Gg, Dd, Dd, Ss, Ss, Ss, Rr, Ss, Ss, Ss, Ss, Ss, Dd, Dd, Dd, Dd, Gg, Gg, Gg, Gg, Gg, Gg, Gg, Gg
Gg, Gg, Gg, Gg, Gg, Gg, Gg, Gg, Gg, Gg, Gg, Gg, Gg, Dd, Dd, Dd, Rr, Dd, Dd, Dd, Dd, Dd, Gg, Dd, Gg, Gg, Gg, Gg, Gg, Gg, Gg, Gg, Gg, Gg
Gg, Gg, Gg, Gg, Gg, Gg, Gg, Gg, Gg, Gg, Gg, Gg, Gg, Gg, Gg, Gg, Rr, Gg, Gg, Gg, Gg, Gg, Gg, Gg, Gg, Gg, Gg, Gg, Gg, Gg, Gg, Gg, Gg, Gg
Gg, Gg, Gg, Gg, Gg, Gg, Gg, Gg, Gg, Gg, Gg, Gg, Gg, Gg, Gg, Gg, Rr, Gg, Gg, Gg, Gg, Gg, Gg, Gg, Gg, Gg, Gg, Gg, Gg, Gg, Gg, Gg, Gg, Gg
