border_size=1
usage=map

Gg          ,Gg          , Gg          , Gg          , Gg          , Hh          , Hh          , Hh          , Gg          , Gg          , Gg          , Rr          , Gg          , Gg          , Hh          , Hh          , Hh          , Gg          , Gg          , Gg          , Gg          , Gg          , Hh          , Hh          , Hh          , Gg          , Gg          , Gg          , Gg          , Gg          , Gg          , Gg          , Gg          , Gg          
Gg          ,Gg          , Gg          , Gg          , Gg          , Hh          , Hh          , Hh          , Gg          , Gg          , Gg          , Rr          , Gg          , Gg          , Hh          , Hh          , Hh          , Gg          , Gg          , Gg          , Gg          , Gg          , Hh          , Hh          , Hh          , Gg          , Gg          , Gg          , Gg          , Gg          , Gg          , Gg          , Gg          , Gg          
Gg          ,Gg          , Gg          , Gg          , Gg          , Hh          , Hh          , Hh          , Gg          , Gg          , Gg          , Rr          , Gg          , Gg          , Hh          , Hh          , Hh          , Gg          , Gg          , Gg          , Gg          , Gg          , Gg          , Hh          , Hh          , Gg          , Gg          , Gg          , Gg          , Gg          , Gg          , Gg          , Gg          , Gg          
Gg          ,Gg          , Gg          , Gg          , Gg          , Hh          , Hh          , Hh          , Gg          , Gg          , Gg          , Rr          , Gg          , Gg          , Gg          , Gg          , Gg          , Gg          , Gg          , Gg          , Gg          , Gg          , Hh          , Hh          , Hh          , Gg          , Gg          , Gg          , Gg          , Gg          , Gg          , Gg          , Gg          , Gg          
Gg          ,Gg          , Gg          , Gg          , Gg          , Gg          , Hh          , Gg          , Gg          , Gg          , Gg          , Rr          , Gg          , Gg          , Gg          , Gg          , Gg          , Gg          , Gg          , Gg          , Gg          , Gg          , Gg          , Gg          , Gg          , Gg          , Gg          , Gg          , Gg          , Gg          , Gg          , Gg          , Gg          , Gg          
Gg          ,Gg          , Gg          , Gg          , Gg          , Gg          , Gg          , Gg          , Gg          , Gg          , Gg          , Rr          , Gg          , Gg          , Gg          , Gg          , Gg          , Gg          , Gg          , Gg          , Gg          , Gg          , Gg          , Gg          , Gg          , Gg          , Gg          , Gg          , Ww          , Gg          , Gg          , Gg          , Ww          , Ww          
Gg          ,Gg          , Hh          , Hh          , Gg^Vh       , Gg          , Gg          , Gg          , Gg          , Gg          , Gg          , Rr          , Hh          , Gg          , Gg          , Gg          , Gg          , Gg          , Gg          , Gg          , Gg          , Gg          , Gg          , Gg          , Gg          , Gg          , Ww          , Ww          , Ww          , Ww          , Ww          , Ww          , Ww          , Ww          
Gg          ,Gg          , Hh          , Hh          , Hh          , Gg          , Gg          , Gg          , Gg          , Gg          , Hh          , Rr          , Hh          , Hh          , Gg          , Gg          , Gg          , Gg          , Gg          , Gg          , Gg          , Gg          , Gg          , Gg          , Ww          , Ww          , Wo          , Ww          , Ww          , Wo          , Wo          , Wo          , Ww          , Ww          
Hh          ,Hh          , Gg          , Hh          , Gg          , Gg          , Gg          , Gg          , Gg          , Gg          , Gg          , Rr          , Hh          , Gg          , Gg          , Gg          , Gg          , Gg          , Gg          , Gg          , Gg          , Gg          , Ww          , Ww          , Wo          , Wo          , Ww          , Ww          , Ww          , Wo          , Ww          , Ww          , Ww          , Ww          
Gg          ,Gg          , Gg          , Hh          , Gg          , Gg          , Gg          , Gg          , Gg          , Gg          , Gg          , Rr          , Gg          , Gg          , Gg          , Gg          , Gg          , Gg          , Gg          , Gg          , Dd          , Dd          , Ww          , Ww          , Ww          , Ww          , Dd          , Gg          , Gg          , Ww          , Gg          , Gg          , Gg          , Gg          
Gg          ,Gg          , Gg          , Gg          , Gg          , Gg          , Gg          , Gg          , Gg          , Gg          , Gg          , Rr          , Gg          , Gg          , Gg          , Gg          , Gg          , Gg          , Dd          , Dd          , Ww          , Ww          , Wo          , Wo          , Ww          , Ss          , Dd          , Dd          , Gg          , Gg          , Gg          , Gg          , Rr          , Rr          
Gg          ,Gg          , Gg          , Gg          , Gg          , Gg          , Gg          , Gg          , Gg          , Gg          , Gg          , Rr          , Gg          , Gg          , Dd          , Gg          , Dd          , Dd          , Ww          , Ww          , Wo          , Wo          , Ww          , Ww          , Ss          , Ss          , Ss          , Dd          , Dd          , Gg          , Rr          , Rr          , Gg          , Gg          
Gg          ,Gg          , Gg          , Gg          , Gg          , Gg          , Gg          , Gg          , Gg          , Gg          , Dd          , Rr          , Dd          , Dd          , Ss          , Dd          , Ww          , Ww          , Wo          , Ww          , Ww          , Ww          , Gg^Vh       , Ss          , Gg          , Ch          , Ch          , Ss          , Rr          , Rr          , Dd          , Gg          , Gg          , Gg          
Rr          ,Rr          , Rr          , Gg          , Gg          , Gg          , Gg          , Gg          , Gg          , Dd          , Dd          , Rr          , Ss          , Ss          , Ch          , Ss          , Ww          , Ww          , Ww          , Ww          , Gg          , Gg^Vh       , Gg          , Gg          , Gg^Vh       , Gg^Vh       , Rr          , Kh          , Ss          , Dd          , Dd          , Gg          , Gg          , Gg          
Gg          ,Gg          , Gg          , Rr          , Rr          , Gg          , Gg          , Gg          , Dd          , Dd          , Ss          , Rr          , Ch          , Ch          , Rr          , Ch          , Ww          , Wo          , Ww          , Ww          , Dd          , Gg^Vh       , Dd          , Dd          , Rr          , Rr          , Gg^Vh       , Ch          , Ss          , Dd          , Dd          , Gg          , Gg          , Gg          
Gg          ,Gg          , Gg          , Gg          , Gg          , Rr          , Rr          , Dd          , Ss          , Ss          , Ch          , Ch          , Rr          , Rr          , Kh          , Rr          , Ww          , Wo          , Ww          , Gg^Vh       , Rr          , Rr          , Rr          , Hh^Vhh      , Rr          , Dd          , Gg          , Ch          , Ss          , Dd          , Dd          , Gg          , Gg          , Gg          
Gg          ,Gg          , Gg          , Gg          , Gg          , Dd          , Dd          , Rr          , Ch          , Ch          , Rr          , Rr          , Kh          , Kh          , Gg^Vh       , Kh          , Ww          , Ww          , Ww^Bw/      , Rr          , Dd          , Hh^Vhh      , Gg^Vh       , Rr          , Rr          , Gg^Vh       , Gg^Vh       , Ch          , Ss          , Dd          , Dd          , Gg          , Gg          , Gg          
Gg          ,Gg          , Gg          , Gg          , Gg          , Gg          , Dd          , Ss          , Ch          , Rr          , Kh          , Kh          , Rr          , Dd          , Gg          , Gg^Vh       , Rr          , Ww^Bw/      , Ww          , Ww          , Dd          , Gg^Vh       , Dd          , Gg          , Gg^Vh       , Rr          , Gg^Vh       , Ch          , Ss          , Dd          , Gg          , Gg          , Gg          , Gg          
Gg          ,Gg          , Gg          , Gg          , Gg          , Dd          , Dd          , Ss          , Ch          , Rr          , Kh          , Gg^Vh       , Gg          , Rr          , Rr          , Rr          , Dd          , Ww          , Wo          , Ww          , Ww          , Dd          , Gg          , Hh^Vhh      , Gg          , Rr          , Gg          , Ch          , Ss          , Dd          , Gg          , Gg          , Gg          , Gg          
Gg          ,Gg          , Gg          , Gg          , Gg          , Dd          , Ww          , Ss          , Ch          , Rr          , Kh          , Dd          , Hh^Vhh      , Dd          , Rr          , Hh^Vhh      , Ww          , Ww          , Wo          , Ww          , Gg^Vh       , Gg^Vh       , Gg          , Dd          , Gg^Vh       , Rr          , Gg^Vh       , Ch          , Ss          , Dd          , Gg          , Gg          , Gg          , Gg          
Gg          ,Gg          , Gg          , Gg          , Ww          , Ww          , Ww          , Ww          , Ww          , Rr          , Ww          , Gg          , Gg^Vh       , Dd          , Dd          , Rr          , Ww^Bw\      , Ww          , Ww          , Ww          , Kh          , Gg^Vh       , Gg^Vh       , Gg^Vh       , Hh^Vhh      , Rr          , Dd          , Ch          , Ss          , Dd          , Gg          , Gg          , Gg          , Gg          
Gg          ,Gg          , Ww          , Ww          , Wo          , Wo          , Wo          , Wo          , Ww          , Ww          , Ww          , Ww          , Ww          , Ww          , Ww          , Ww          , Ww          , Ww^Bw\      , Rr          , Dd          , Dd          , Kh          , Kh          , Gg^Vh       , Gg^Vh       , Rr          , Dd          , Ch          , Ss          , Dd          , Gg          , Gg          , Gg          , Gg          
Ww          ,Ww          , Wo          , Wo          , Ww          , Ww          , Ww          , Ww          , Ww          , Wo          , Wo          , Wo          , Wo          , Wo          , Ww          , Ww          , Ww          , Ww          , Gg          , Rr          , 1 Rr        , Gg^Ve       , Dd          , Kh          , Dd          , Rr          , Gg^Vh       , Ch          , Ss          , Dd          , Gg          , Gg          , Gg          , Gg          
Ww          ,Ww          , Ww          , Ww          , Gg          , Dd          , Dd          , Ss          , Ch          , Ww          , Ww          , Ww          , Ww          , Ww          , Dd          , Ww          , Kh          , Dd          , Gg^Ve       , Rr          , Rr          , Rr          , Gg^Ve       , Kh          , Dd          , Rr          , Gg          , Ch          , Ss          , Dd          , Dd          , Gg          , Gg          , Gg          
Ww          ,Ww          , Gg          , Gg          , Gg          , Dd          , Dd          , Ss          , Ch          , Gg^Vh       , Dd          , Gg          , Gg^Vh       , Dd          , Hh^Vhh      , Gg^Vh       , Gg^Vh       , Kh          , Kh          , Dd          , Gg^Ve       , Gg^Ve       , Kh          , Kh          , Gg^Vh       , Rr          , Gg^Vh       , Ch          , Ss          , Dd          , Gg          , Gg          , Gg          , Gg          
Gg          ,Gg          , Gg          , Gg          , Gg          , Dd          , Dd          , Ss          , Ch          , Gg^Vh       , Rr          , Hh^Vhh      , Rr          , Gg          , Gg^Vh       , Dd          , Dd          , Dd          , Gg^Vh       , Kh          , Kh          , Kh          , Dd          , Gg^Vh       , Rr          , Rr          , Rr          , Ch          , Ss          , Dd          , Gg          , Gg          , Gg          , Gg          
Gg          ,Gg          , Gg          , Gg          , Gg          , Dd          , Dd          , Ss          , Kh          , Rr          , Gg^Vh       , Rr          , Dd          , Rr          , Rr          , Gg          , Hh^Vhh      , Gg^Vh       , Hh^Vhh      , Dd          , Dd          , Gg^Vh       , Rr          , Rr          , Gg^Vh       , Gg^Vh       , Ch          , Kh          , Rr          , Dd          , Gg          , Gg          , Gg          , Gg          
Gg          ,Gg          , Gg          , Hh          , Hh          , Gg          , Rr          , Rr          , Ss          , Ch          , Ch          , Gg^Vh       , Dd          , Dd          , Dd          , Rr          , Rr          , Rr          , Rr          , Rr          , Rr          , Rr          , Gg^Vh       , Dd          , Ch          , Ch          , Ss          , Ss          , Dd          , Rr          , Rr          , Gg          , Rr          , Rr          
Gg          ,Gg          , Hh          , Hh          , Rr          , Rr          , Gg          , Dd          , Dd          , Ss          , Ss          , Ch          , Ch          , Gg^Vh       , Gg^Vh       , Gg^Vh       , Rr          , Dd          , Gg^Vh       , Gg          , Gg^Vh       , Dd          , Ch          , Ch          , Ss          , Ss          , Dd          , Dd          , Dd          , Gg          , Gg          , Rr          , Gg          , Gg          
Gg          ,Gg          , Rr          , Rr          , Gg          , Hh          , Gg          , Dd          , Gg          , Dd          , Dd          , Ss          , Ss          , Ch          , Ch          , Ch          , Kh          , Ch          , Ch          , Ch          , Ch          , Ch          , Ss          , Ss          , Dd          , Dd          , Gg          , Gg          , Gg          , Gg          , Gg          , Gg          , Gg          , Gg          
Rr          ,Rr          , Gg          , Gg          , Gg          , Gg          , Gg          , Gg          , Gg          , Gg          , Gg          , Dd          , Dd          , Ss          , Ss          , Ss          , Rr          , Ss          , Ss          , Ss          , Ss          , Ss          , Dd          , Dd          , Dd          , Dd          , Gg          , Gg          , Gg          , Gg          , Gg          , Gg          , Gg          , Gg          
Gg          ,Gg          , Gg          , Gg          , Gg          , Gg          , Gg          , Gg          , Gg          , Gg          , Gg          , Gg          , Gg          , Dd          , Dd          , Dd          , Rr          , Dd          , Dd          , Dd          , Dd          , Dd          , Gg          , Dd          , Gg          , Gg          , Gg          , Gg          , Gg          , Gg          , Gg          , Gg          , Gg          , Gg          
Gg          ,Gg          , Gg          , Gg          , Gg          , Gg          , Gg          , Gg          , Gg          , Gg          , Gg          , Gg          , Gg          , Gg          , Gg          , Gg          , Rr          , Gg          , Gg          , Gg          , Gg          , Gg          , Gg          , Gg          , Gg          , Gg          , Gg          , Gg          , Gg          , Gg          , Gg          , Gg          , Gg          , Gg          
Gg          ,Gg          , Gg          , Gg          , Gg          , Gg          , Gg          , Gg          , Gg          , Gg          , Gg          , Gg          , Gg          , Gg          , Gg          , Gg          , Rr          , Gg          , Gg          , Gg          , Gg          , Gg          , Gg          , Gg          , Gg          , Gg          , Gg          , Gg          , Gg          , Gg          , Gg          , Gg          , Gg          , Gg          
Gg          ,Gg          , Gg          , Gg          , Gg          , Gg          , Gg          , Gg          , Gg          , Gg          , Gg          , Gg          , Gg          , Gg          , Gg          , Gg          , Rr          , Gg          , Gg          , Gg          , Gg          , Gg          , Gg          , Gg          , Gg          , Gg          , Gg          , Gg          , Gg          , Gg          , Gg          , Gg          , Gg          , Gg          
