Aa^Fpa, Aa^Fdw, Aa^Fma, Ha, Ha, Gg, Aa^Fpa, Aa^Fpa, Aa^Fdw, Gg, Ha, Aa, Aa, Gg, Ds, Ai, Ww, Ww, Ai, Wo, Wo, Wo, Wo, Wo, Wo, Wo, Wo, Wo, Wo, Wo, Wo, Wo, Wo, Wo, Wo, Wo, Wo, Wo, Wo, Wo, Wo, Wo, Wo, Wo, Wo, Wo
Aa^Fpa, Aa^Fma, Aa^Fdw, Ha, Ha, Gg, Aa^Fpa, Aa^Fma, Aa^Fdw, Gs, Ha, Aa, Aa, Gg, Ds, Ai, Ww, Ww, Ai, Wo, Wo, Wo, Wo, Wo, Wo, Wo, Wo, Wo, Wo, Wo, Wo, Wo, Wo, Wo, Wo, Wo, Wo, Wo, Wo, Wo, Wo, Wo, Wo, Wo, Wo, Wo
Gs^Fp, Gs^Fmw, Aa^Fdw, Aa^Fma, Gg, Gs^Fp, Aa^Fpa, Aa^Fpa, Aa^Fpa, Ha, Ha, Ha, Ds, Gg, Ds, Ai, Ww, Wo, Ai, Ai, Wo, Wo, Wo, Wo, Wo, Wo, Wo, Wo, Wo, Wo, Wo, Wo, Wo, Wo, Wo, Wo, Wo, Wo, Wo, Wo, Wo, Wo, Wo, Wo, Wo, Wo
Gs^Fp, Gs^Fp, Gs, Gs, Ha, Aa^Fpa, Aa^Fdw, Aa^Fma, Aa^Fdw, Ha, Ha, Ha, Gg, Gg, Ce, Ai, Ai, Ww, Wo, Wo, Wo, Wo, Wo, Wo, Wo, Wo, Wo, Wo, Wo, Wo, Wo, Wo, Wo, Wo, Wo, Wo, Wo, Wo, Wo, Wo, Wo, Wo, Wo, Wo, Wo, Wo
Aa^Fpa, Aa^Fma, Ha, Ha, Ha, Gg, Ha, Ha, Aa, Gs^Fmw, Aa^Fma, Ds, Gg, Gg^Ve, Rr, Gg^Vh, Ce, Ww, Ww, Wo, Wo, Wo, Wo, Wo, Wo, Wo, Wo, Wo, Wo, Wo, Wo, Wo, Wo, Wo, Wo, Wo, Wo, Wo, Wo, Wo, Wo, Wo, Wo, Wo, Wo, Wo
Gg, Gg, Gs^Fp, Gs, Aa^Fpa, Gs, Ha, Ha, Aa^Fpa, Gs^Fdw, Gs, Ds, Ce, Gg, Rr, Rr, Rr, Ww, Ww, Ww, Wo, Wo, Wo, Wo, Wo, Wo, Wo, Wo, Wo, Wo, Wo, Wo, Wo, Wo, Wo, Wo, Wo, Wo, Wo, Wo, Wo, Wo, Wo, Wo, Wo, Wo
Gs^Fp, Gs^Fp, Gs, Aa^Fpa, Aa^Fpa, Ha, Ha, Aa^Fma, Gs^Fmw, Aa^Fpa, Ha, Ds, Ds, Gg^Vh, Gg, Rr, Ce, Rr, Ww^Bw\, Ww, Wo, Wo, Wo, Wo, Wo, Wo, Wo, Wo, Wo, Wo, Wo, Wo, Wo, Wo, Wo, Wo, Wo, Wo, Wo, Wo, Wo, Wo, Wo, Wo, Wo, Wo
Gg, Gs, Aa^Fpa, Aa^Fma, Aa^Fma, Aa^Fpa, Gg, Aa^Fpa, Aa^Fma, Ha, Ha, Ds, Ds, Gg, Ce, Gg^Vh, Ww, Ww, Ww, Ww^Bw\, Rr, Wo, Wo, Wo, Wo, Wo, Wo, Wo, Wo, Wo, Wo, Wo, Wo, Wo, Wo, Wo, Wo, Wo, Wo, Wo, Ww, Wo, Ww, Wo, Wo, Wo
Gg, Gg, Gs^Fp, Aa^Fpa, Gs^Fmw, Aa^Fpa, Gs, Aa^Fma, Gs^Fp, Ha, Gs^Fp, Ha, Gg, Ds, Ww, Ww, Ww, Ww, Ww, Ww, Ww^Bw|, Wo, Ww, Wo, Wo, Wo, Wo, Wo, Wo, Wo, Wo, Wo, Wo, Wo, Wo, Wo, Wo, Wo, Wo, Ww, Ww, Ai, Ai, Ww, Ww, Ww
Gs^Fp, Gs^Fp, Aa^Fpa, Aa^Fpa, Gs^Fp, Ha, Aa^Fma, Aa^Fdw, Aa, Gs^Fmw, Gs^Fp, Gs^Fp, Aa, Ds, Ww, Ww, Wo, Ww, Ww, Ww, Ww^Bw|, Ww, Ch, Ww, Ww, Wo, Wo, Wo, Wo, Wo, Wo, Wo, Wo, Wo, Wo, Wo, Wo, Wo, Wo, Ww, Ds, Ds, Ai, Ai, Ww, Ww
Gs^Fp, Gs^Fmw, Gs^Fmw, Aa^Fma, Aa^Fma, Aa^Fpa, Aa^Fma, Aa^Fpa, Ha, Aa, Aa, Aa, Ds, Ds, Ww, Wo, Wo, Wo, Ww, Ww, Rr, Ch, Rr, Ch, Ch, Ww, Ww, Wo, Wo, Wo, Wo, Wo, Wo, Wo, Ww, Ww, Ww, Ww, Ww, Ww, Ds, Ds, Ds, Ds, Ds, Ds
Gs^Fp, Gs^Fmw, Gs^Fp, Gg^Ve, Aa^Fdw, Aa^Fma, Gg, Gs^Fp, Aa, Ha, Gg, Gs, Ds, Ww, Ww, Wo, Wo, Wo, Ww, Ch, Rr, Rr, Rr, Rr, Rr, Ch, Ch, Wo, Wo, Wo, Wo, Wo, Wo, Ww, Ds, Ds, Ds, Ww, Ds, Ds, Gs, Gg, Aa^Fpa, Gg, Aa^Fdw, Aa^Fpa
Gg, Gg, Ha, Gs^Fp, Aa^Fpa, Gg, Gs, Gs^Fmw, Aa^Fma, Aa^Fdw, Hh, Gs, Gg, Ds, Ww, Wo, Wo, Ww, Ww, Ch, Rr, Rr, Kh, Kh, Kh, Rr, Rr, Ch, Ww^Bw\, Wo, Ww, Wo, Ww, Ww, Ds, Ds, Rr, Ds, Re, Ds, Gg, Aa^Fma, Gs^Fmw, Gs^Fp, Aa^Fma, Aa^Fpa
Gg, Gs, Ha, Aa, Aa^Fpa, Aa^Fma, Gg^Ve, Gs, Aa^Fma, Hh, Gs^Fdw, Aa, Aa, Ds, Wwf, Ww, Ww, Wo, Ww, Ch, Ch, Rr, Rr, 3 Kh, Kh, Rr, Rr, Ch, Wwf, Ww^Bw\, Wo, Wo, Wwf, Wwf, Ds, Ds, Ds, Rr, Rr, Re, Gs, Gs^Fp, Hh, Gg, Gs^Fdw, Gs^Fp
Gg, Gg, Gs^Fmw, Aa, Aa, Aa^Fpa, Gs^Fp, Gg, Aa^Fpa, Hh, Gs^Fmw, Gg, Aa, Gg, Wwf, Wwf, Ww, Ww, Wo, Ww, Ww, Ch, Rr, Kh, Rr, Rr, Ch, Ch, Wwf, Wwf, Wo, Ww, Ww, Wwf, Wwf, Ds, Gs^Fmw, Gs^Fmw, Gs^Fdw, Gs^Fp, Gs^Fdw, Gs^Fdw, Hh, Gg^Ve, Gs^Fmw, Gs^Fp
Gg, Gs, Gs^Fp, Hh, Aa, Gg, Gs, Gs, Gg, Aa^Fpa, Gs, Gs, Gs, Gg, Gg, Wwf, Wwf, Ww, Ww, Ww, Ww, Ch, Ch, Rr, Ww^Bw|, Ch, Ww, Ww, Ww, Ww, Ww, Wo, Ww, Ww^Bw\, Gg, Gs^Fp, Gs^Fdw, Gs, Rr, Gs^Fp, Gs, Gs^Fmw, Gs^Fmw, Gs, Gs, Gg
Gg, Gg, Aa^Fpa, Gs, Hh, Gs^Fp, Aa^Fpa, Aa^Fma, Gg, Gs^Fmw, Gg, Gs^Fmw, Gs^Fdw, Gs^Fmw, Gg, Gg, Gg, Ww, Ww, Ww, Wo, Ww, Ww, Ch, Ww, Ww, Wo, Wo, Wo, Wo, Wo, Wo, Wo, Wo, Ww, Ds, Ds, Gs^Fp, Gs^Fdw, Gs^Fmw, Gg, Gs^Fp, Gs^Fp, Hh, Hh, Hh
Gg, Gs, Gs^Fp, Gs^Fp, Gg^Ve, Gs^Fp, Gs, Gg, Aa^Fdw, Gs^Fp, Hh, Gs, Gg, Gs^Fdw, Gs, Gg, Gg, Wwf, Wwf, Ww, Wo, Wo, Wo, Wo, Wo, Wo, Ww, Wo, Wo, Wo, Wo, Wo, Wo, Ww, Ww, Wwf, Ds, Gg, Rr, Re, Gg, Gs, Gg, Hh, Hh, Hh
Gs^Fp, Gs^Fp, Gs, Aa^Fma, Gs^Fp, Gs, Aa^Fma, Hh, Hh, Gg, Hh, Hh, Gs^Fp, Gs, Gg, Gg, Gg, Wwf, Ww, Wo, Ww, Ww, Ww, Ww, Ww^Bw|, Ww, Ds, Ww, Ww, Wo, Wo, Wo, Ww, Ww, Ww, Ds, Gg, Gs^Fp, Rr, Re, Gg, Gs, Gs^Fmw, Hh, Hh, Hh
Gg, Gs, Gs, Gg, Gs^Fmw, Gs^Fp, Gg, Aa^Fma, Gs^Fmw, Hh, Gs, Gg, Hh, Gg, Gg, Gg, Ww, Ww, Wo, Wo, Wwf, Wwf, Ds, Ds, Rr, Ds, Gg, Ww, Ww, Ww, Ww, Ww, Ww, Ww, Ds, Ds, Rr, Rr, Re, Rr, Rr, Gg, Gs, Gg, Hh, Hh
Gs^Fp, Gs^Fp, Gg, Gs^Fdw, Gs^Fmw, Gs, Gs^Fp, Aa^Fdw, Gs^Fp, Gs^Fp, Hh, Hh, Gs, Gg, Gg, Ww, Ww, Ww, Wo, Wwf, Wwf, Re, Gg, Gg^Vh, Rr, Gg, Gg, Ds, Ds, Ww, Ds, Ds, Gg, Ds, Gs^Fp, Rr, Re, Re, Gg, Gg, Gg, Gs^Fp, Gs^Fmw, Gs, Gs^Fmw, Gs^Fp
Gs^Fp, Gs^Fp, Gs^Fp, Gs^Fdw, Gs, Gs^Fp, Gg, Gs, Gs, Gs^Fp, Gs, Hh, Gg, Gg, Gg, Ww, Ww, Ww, Ww, Ww, Gg, Re, Re, Gg, Rr, Gg, Gg^Vh, Gg, Gg, Gg, Gg, Gg, Gg^Vh, Gs^Fdw, Rr, Rr, Re, Gg, Gg, Gg, Gg, Gg, Gs, Gs^Fdw, Gs^Fmw, Gs^Fp
Gs, Gg, Gs, Gs^Fp, Gs^Fp, Gs^Fp, Gg, Gs^Fmw, Gg, Gg, Gg, Gg, Gg, Gg, Ww, Ww, Wo, Ww, Gg, Gg, Gg, Gg, Gg, Re, Re, Rr, Rr, Gg, Gg, Gg, Gg^Vh, Gg, Rr, Rr, Re, Re, Gg, Gs, Gs^Fdw, Gs, Rr, Gs^Fdw, Gs^Fmw, Gg, Gs^Fp, Gs^Fp
Gs, Gs, Gg, Gg^Ve, Gs, Gs^Fmw, Gs^Fp, Gs^Fdw, Gg, Gg, Gg, Gg, Ww, Ww, Wo, Wo, Ww, Ww, Gg, Gg, Gg, Gg, Gg, Gg, Gg, Re, Re, Rr, Rr, Rr, Rr, Rr, 2 Ke, Ce, Gg, Gg, Gs, Gs^Fdw, Gs^Fmw, Gg, Gg, Rr, Rr, Gs, Gs, Gg
Gg, Gg, Hh, Hh, Gg, Gg, Hh, Gg, Ww, Gg, Ww, Ww, Wo, Wo, Wo, Ww, Ww, Gg, Gg, Gg, Hh, Hh, Gg, Gg, Gg, Gg, Gg, Rr, Rr, Ce, Ce, Ce, Gg, Gg, Gg, Gg, Gs, Gs, Gs^Fp, Gg^Ve, Gs^Fp, Gg, Gg, Gg, Rr, Rr
Gg, Gg, Hh, Hh, Gg, Gg, Gg, Ww, Ww, Ww, Ww, Ww, Ww, Ww, Gg, Ww, Gg, Gg, Hh, Hh, Hh, Hh, Gg, Gg, Gg, Gg, Gg, Gg, Gg, Gg, Gg, Gg, Gg, Gg, Gg, Gs^Fdw, Gs, Gg, Gs^Fp, Gs, Gs^Fp, Gg, Gs^Fdw, Gg, Gg, Gg
Hh, Hh, Hh, Hh, Gg, Gg, Ww, Ww, Wo, Wo, Ww, Ww, Ww, Ww, Gg, Gg, Gg, Hh, Hh, Hh, Hh, Hh, Gg, Gg, Rr, Gg, Rr, Gg, Gg, Gg, Gg, Gg, Gg, Gg, Gg, Gg, Gg, Gs, Gg, Gg, Gs, Gg, Gs^Fdw, Gs^Fmw, Gs^Fp, Gs^Fp
Gg, Gg, Gg, Hh, Gg, Ww, Ww, Wo, Ww, Ww, Gg, Gg, Hh, Gg, Gg, Gg, Gs^Fdw, Gs^Fdw, Gg, Hh, Gg, Gg, Rr, Rr, Chr, Rr, Gg, Gg, Gg, Gg, Gs^Fdw, Gs^Fp, Gg, Gg, Gg^Vh, Ww, Gg, Gg, Gg, Gg, Gg, Gs, Gs^Fmw, Gs^Fp, Gs^Fp, Gs^Fp
Gg, Gg, Gg, Gg, Gg, Ww, Ww, Wo, Ww, Ww, Hh, Hh, Hh, Gg, Gg^Vh, Gg, Gg, Gs^Fmw, Gs^Fp, Gg, Gg, Rr, Gg, Chr, Rp^Vhcr, Chr, Gg, Gg, Gg, Gs^Fp, Gs^Fmw, Gs, Gs, Gg, Gg, Gg, Gg, Gg, Gg, Gg, Gg, Gs^Fp, Gs^Fmw, Gs, Gs^Fp, Gs^Fp
Gg, Gg, Gg, Gg, Gg, Ww, Ww, Ww, Ww, Gg, Gg, Gg, Gg, Gg, Gg, Ww, Gg, Gs^Fp, Gg, Gg, Gg, Rr, Gg, Chr, Chr, Khr, Gg, Gg, Gg, Gg, Gs, Gs^Fp, Gg, Gs, Gg, Gg, Gg, Gg, Gg, Gg, Gg, Gg, Gs^Fdw, Gg^Ve, Gs, Gg
Gg, Gg, Hh, Hh, Gg, Ww, Ww, Wo, Ww, Gg, Gg, Gg, Gg, Gg, Gg, Gg, Gg, Gg, Gg, Rr, Gg, Gg, Gg, Gg, Gg, Gg, Gg, Gg, Gg, Gg, Gg, Gg, Gg, Gg, Gg, Gs, Gs, Gg, Gg, Gg, Gg, Gg, Gs^Fdw, Gs^Fmw, Gs^Fp, Gs^Fp
Gg, Gg, Hh, Hh, Gg, Ww, Ww, Wo, Wo, Ww, Gg, Gg, Hh, Hh, Gg, Gg, Gg, Gg, Gg, Rr, Gg, Gg, Gg, Gg, Gg, Gg, Gg, Gg, Gg, Gg, Gg, Gg, Gg, Gg, Gg, Gs^Fmw, Gg, Gg, Gg, Gg, Gg, Gs^Fp, Gs, Gs^Fp, Gg, Gg
Gg, Gg, Hh, Hh, Gg, Gg, Ww, Wo, Ww, Ww, Gg, Gg, Hh, Hh, Gg, Gg, Khr, Chr, Chr, Rr, Gg, Gg, Gg, Gg, Gg, Gg, Gg, Gg, Gg, Gg, Gg, Gg, Gg, Gg, Gg, Gg, Gg, Gg, Gg^Vh, Gg, Gg, Gg, Gg^Ve, Gs, Gs^Fp, Gs^Fp
Gg, Gg, Gg, Gg^Ve, Gg, Gg, Ww, Ww, Ww, Ww, Gg, Gg, Gg, Gg, Gg, Gg, Chr, Rp^Vhcr, Chr, Rr, Gg, Gg, Gg, Gg, Gg, Gg, Gg, Gg, Gg, Gg, Gg, Gg, Gg, Gg, Gg, Gg, Gg, Gg, Gg, Ww, Gg, Gg, Gg, Gs^Fmw, Gg, Gg
Gg, Gg, Gg, Gg, Gg, Gg, Ww, Ww, Ww, Gg, Gg, Gg, Gg, Gg, Rr, Gg, Rr, Chr, Rr, Rr, Gg, Gg, Gg, Gg, Gg, Gg, Gg, Gg, Gg, Gg, Gg, Gg, Gg, Gg, Gg, Gg, Gg, Gg, Gg, Gg, Gg, Gg, Gs, Gs, Gs, Gs
Gg, Gg, Ww, Ww, Ww, Ww, Wo, Wo, Ww, Gg, Gg, Gg^Vh, Gg, Rr, Gg, Rr, Gg, Rr, Gg, Gg, Gg, Gg, Gg, Gg, Gg, Gg, Gg, Gg, Gg, Gg, Gg, Gg, Gg, Gg, Gg, Gg, Gg, Gg, Gg, Gg, Gg, Gg, Gg, Gs^Fmw, Gg, Gg
Ww, Ww, Wo, Ww, Ww, Wo, Ww, Ww, Gg, Gg, 1 Gg, Gg, Rr, Gg, Gg, Gg, Gg, Gg, Gg, Gg, Gg, Gg, Gg, Gg, Gg, Gg, Gg^Vh, Ww, Gg, Gg, Gg, Gg, Gg, Gg, Gg, Gg, Gg, Gg, Gg, Gg, Gg, Gg, Gg, Gg, Gg, Gg
Wo, Wo, Ww, Ww, Ww, Ww, Gg, Gg, Gg, Gg, Gg, Rr, Gg, Gg, Gg, Gg, Gg, Gg, Gg, Gg, Gg, Gg, Gg, Gg, Gg, Gg, Gg, Gg, Gg, Gg, Gg, Gg, Gg, Gg, Gg, Gg, Gg, Gg, Gg, Gg, Gg, Gg, Gg, Gg, Gg, Gg
Ww, Ww, Ww, Gg, Gg, Gg, Gg, Gg, Gg, Gg, Rr, Rr, Gg, Gg, Gg, Gg, Gg, Gg, Gg, Gg, Gg, Gg, Gg, Gg, Gg, Gg, Gg, Gg, Gg, Gg, Gg, Gg, Gg, Gg, Gg, Gg, Gg, Gg, Gg, Gg, Gg, Gg, Gg, Gg, Gg, Gg
Ww, Ww, Ww, Gg, Gg, Gg, Gg, Gg, Gg, Gg, Rr, Gg, Gg, Gg, Gg, Gg, Gg, Gg, Gg, Gg, Gg, Gg, Gg, Gg, Gg, Gg, Gg, Gg, Gg, Gg, Gg, Gg, Gg, Gg, Gg, Gg, Gg, Gg, Gg, Gg, Gg, Gg, Gg, Gg, Gg, Gg
