border_size=1
usage=map

Gg          , Gg          , Gg          , Gg          , Gg          , Gg          , Gg          , Gg          , Gg          , Gg          , Gg          , Gg          , Gg          , Hh          , Gg          , Gg          , Gs^Fp       , Gs^Fp       , Gs^Fp       , Gg          , Gg          , Gg          , Gs^Fp       , Gs^Fp       , Gg          , Gg          , Re          , Gg          
Gg          , Gg          , Gg          , Gg          , Gg          , Gg^Vh       , Gg          , Gg          , Gg          , Gg          , Gg          , Gg          , Gg          , Hh          , Gg          , Gg          , Gs^Fp       , Gs^Fp       , Gs^Fp       , Gg          , Gg          , Gg          , Gs^Fp       , Gs^Fp       , Gg          , Gg          , Re          , Gg          
Gg          , Gg          , Gg          , Gg          , Gg          , Gg          , Gg          , Gs^Fp       , Hh          , Mm          , Mm          , Gg          , Gg          , Gg          , Gg          , Gg          , Gg          , Gs^Fp       , Gs^Fp       , Gg          , Gg          , Gg^Vh       , Ch          , Ch          , Ch          , Re          , Gg          , Gg          
Gg          , Gg          , Gg          , Gs^Fp       , Gs^Fp       , Gg          , Hh          , Hh          , Mm          , Mm          , Mm          , Mm          , Mm          , Hh          , Gg          , Gs^Fp       , Gs^Fp       , Gg          , Gg          , Gs^Fp       , Gg          , Gg          , Ch          , 2 Kh        , Ch          , Re          , Gs^Fp       , Gs^Fp       
Gg          , Gg          , Gg          , Gs^Fp       , Gs^Fp       , Gg^Vh       , Hh          , Mm          , Mm          , Mm          , Mm          , Mm          , Mm          , Mm          , Hh          , Hh          , Gs^Fp       , Gg          , Gg          , Gg          , Gg          , Gg          , Gs^Fp       , Ch          , Re          , Re          , Gs^Fp       , Gs^Fp       
Mm          , Mm          , Gs^Fp       , Gg          , Gs^Fp       , Gs^Fp       , Hh          , Mm          , Mm          , Mm          , Mm          , Mm          , Mm          , Mm          , Mm          , Hh          , Mm          , Hh          , Hh          , Hh          , Hh          , Gg          , Gg          , Gs^Fp       , Re          , Gs^Fp       , Gs^Fp       , Gs^Fp       
Mm          , Mm          , Gs^Fp       , Gs^Fp       , Hh          , Mm          , Mm          , Mm          , Mm          , Mm          , Mm          , Mm          , Mm          , Mm          , Mm          , Mm          , Mm          , Mm          , Mm          , Mm          , Gg          , Gg          , Gg          , Gg          , Re          , Gg          , Hh          , Hh          
Mm          , Mm          , Mm          , Mm          , Mm          , Mm          , Mm          , Mm          , Mm          , Mm          , Mm          , Mm          , Mm          , Mm          , Mm          , Hh          , Gg^Ve       , Mm          , Mm          , Mm          , Gg          , Gg          , Gg          , Re          , Gg          , Gg          , Gg          , Gg          
Gg          , Gg          , Gs^Fp       , Gs^Fp       , Hh          , Mm          , Mm          , Mm          , Mm          , Mm          , Mm          , Mm          , Mm          , Mm          , Mm          , Mm          , Gg          , Gg          , Gg          , Gg          , Hh          , Gg          , Gg          , Re          , Gg          , Gg^Vh       , Hh          , Hh          
Gg          , Gg          , Gs^Fp       , Gs^Fp       , Gs^Fp       , Gs^Fp       , Gg          , Gg          , Gg          , Mm          , Mm          , Mm          , Gs^Fp       , Gs^Fp       , Hh          , Hh          , Hh          , Hh          , Hh          , Hh          , Mm          , Gg          , Gg          , Re          , Gg          , Hh          , Mm          , Mm          
Gs^Fp       , Gs^Fp       , Gs^Fp       , Gs^Fp       , Gg          , Mm^Vhh      , Gg          , Gs^Fp       , Gg          , Gs^Fp       , Gs^Fp       , Mm          , Mm          , Mm          , Mm          , Mm          , Mm          , Mm          , Mm          , Hh          , Mm          , Gg          , Gg          , Re          , Gg          , Hh          , Hh          , Hh          
Gs^Fp       , Gs^Fp       , Gs^Fp       , Gg          , Gg          , Gg          , Gg          , Gg          , Gg          , Gs^Fp       , Gs^Fp       , Mm          , Gs^Fp       , Mm          , Mm          , Mm          , Mm          , Mm          , Mm          , Hh          , Mm          , Gg          , Gg          , Re          , Re          , Gg          , Hh          , Hh          
Gg          , Gg          , Gg          , Gs^Fp       , Gg          , Gg          , Gg          , Gg          , Gg          , Gs^Fp       , Mm          , Mm          , Mm          , Gs^Fp       , Mm^Vhh      , Mm          , Mm          , Mm          , Mm          , Hh^Vhh      , Hh          , Mm          , Hh          , Gg          , Re          , Gg          , Mm          , Mm          
Gg          , Gg          , Gg          , Gs^Fp       , Gg          , Gg          , Gg          , Gg          , Re          , Gs^Fp       , Gs^Fp       , Gs^Fp       , Re          , Gg          , Gs^Fp       , Mm          , Mm          , Mm          , Mm          , Mm          , Hh          , Hh          , Gg          , Gg          , Re          , Gg          , Mm          , Mm          
Gg          , Gg          , Gg          , Gs^Fp       , Gg          , Hh          , Hh          , Re          , Gs^Fp       , Re          , Re          , Re          , Gs^Fp       , Re          , Re          , Gg          , Gg          , Mm          , Mm          , Mm          , Hh          , Gg          , Gg          , Gg          , Re          , Gg          , Mm          , Mm          
Gg          , Gg          , Gs^Fp       , Gg          , Gg          , Hh          , Hh          , Re          , Gs^Fp       , Gs^Fp       , Gs^Fp       , Gs^Fp       , Gs^Fp       , Gs^Fp       , Re          , Gg          , Gg          , Gg          , Gg          , Gg          , Gg          , Gg          , Gg          , Re          , Gg          , Gg          , Hh          , Hh          
Gg          , Gg          , Gg          , Gg          , Hh          , Hh          , Mm          , Re          , Gs^Fp       , Gs^Fp       , Gs^Fp       , Gs^Fp       , Gg          , Gs^Fp       , Gg          , Re          , Re          , Re          , Re          , Gg          , Re          , Gg          , Re          , Re          , Gg          , Gg^Vh       , Gs^Fp       , Gs^Fp       
Gg          , Gg          , Gg          , Gg          , Hh          , Hh          , Hh          , Re          , Gg          , Hh^Vhh      , Gg          , Gg          , Gg          , Gs^Fp       , Mm          , Gg          , Gg          , Gg          , Gg          , Re          , Gg          , Re          , Gg          , Gg          , Gg          , Gg          , Gs^Fp       , Gs^Fp       
Gg          , Gg          , Gg          , Gg          , Hh          , Hh          , Hh          , Re          , Re          , Hh          , Gg          , Gg          , Hh          , Mm          , Mm          , Gg          , Gg          , Gg          , Mm          , Gg          , Gg          , Gg          , Gg          , Gg          , Gg          , Gs^Fp       , Gs^Fp       , Gs^Fp       
Gg          , Gg          , Gg          , Gs^Fp       , Gg          , Hh          , Hh          , Gg          , Re          , Hh          , Gg          , Hh          , Mm          , Mm          , Mm          , Gg          , Gg^Vh       , Hh          , Gs^Fp       , Gg          , Gg          , Gg          , Gg          , Gg          , Gg          , Gs^Fp       , Gs^Fp       , Gs^Fp       
Gg          , Gg          , Gg          , Gg          , Gs^Fp       , Hh          , Hh          , Hh          , Re          , Hh          , Hh          , Hh          , Hh          , Mm          , Mm          , Mm          , Mm          , Hh          , Gs^Fp       , Mm          , Gg          , Gg          , Gg          , Hh          , Gg          , Gs^Fp       , Gs^Fp       , Gs^Fp       
Gg          , Gg          , Gg          , Gg          , Gg^Vh       , Gs^Fp       , Ch          , Gs^Fp       , Hh          , Re          , Gg          , Hh          , Hh          , Hh          , Mm          , Mm          , Mm          , Hh          , Gs^Fp       , Gs^Fp       , Gs^Fp       , Gs^Fp       , Hh          , Gs^Fp       , Gs^Fp       , Gs^Fp       , Gg          , Gg          
Gg          , Gg          , Gg          , Gg          , Gg          , Ch          , 1 Kh        , Ch          , Hh          , Re          , Re          , Hh          , Hh          , Hh          , Hh          , Mm          , Mm          , Hh          , Gs^Fp       , Gs^Fp       , Gs^Fp       , Gs^Fp       , Mm          , Gs^Fp       , Gg          , Gg          , Gg          , Gg          
Gg          , Gg          , Gg          , Gg          , Gg          , Ch          , Ch          , Ch          , Gg          , Hh          , Re          , Gg^Vh       , Gs^Fp       , Gs^Fp       , Gs^Fp       , Hh          , Gs^Fp       , Gg          , Gs^Fp       , Hh          , Mm          , Mm          , Mm          , Mm          , Hh          , Hh          , Gg          , Gg          
Gg          , Gg          , Gg          , Gg          , Re          , Gg          , Re          , Gg          , Re          , Re          , Gg          , Gg          , Gg          , Gg          , Gg          , Gs^Fp       , Gs^Fp       , Gs^Fp       , Hh          , Gs^Fp       , Mm          , Mm          , Mm          , Hh          , Hh          , Hh          , Hh          , Hh          
Gg          , Gg          , Re          , Re          , Gg          , Re          , Gg          , Re          , Gg          , Gg          , Gs^Fp       , Gs^Fp       , Gs^Fp       , Gs^Fp       , Gs^Fp       , Gg          , Gs^Fp       , Gs^Fp       , Hh          , Hh          , Hh          , Hh          , Hh          , Hh          , Hh          , Hh          , Hh          , Hh          
Re          , Re          , Gg          , Gg          , Gg          , Gg          , Gg          , Gg          , Gg          , Gg          , Gs^Fp       , Gs^Fp       , Gs^Fp       , Gs^Fp       , Gs^Fp       , Gg          , Gs^Fp       , Gs^Fp       , Hh          , Hh          , Hh          , Hh          , Hh          , Hh          , Hh          , Hh          , Hh          , Hh          
