border_size=1
usage=map

Gs^Fp       , Gs^Fp       , Gg          , Gs^Fp       , Gg          , Gs^Fp       , Gs^Fp       , Gg          , Gs^Fp       , Gs^Fp       , Gs^Fp       , Gg          , Gs^Fp       , Gg          , Gs^Fp       , Gs^Fp       , Gg          , Gg          , Gg          , Gg          , Gg          , Gg          , Gg          , Gs^Fp       , Gg          , Gg          , Gg          , Gg          , Gg          , Gs^Fp       , Gs^Fp       , Gg          , Gg          , Gg          , Gg          , Gg          , Gg          
Gs^Fp       , Gs^Fp       , Gg          , Gs^Fp       , Gg^Vh       , Gs^Fp       , Gs^Fp       , Gg          , Gs^Fp       , Gs^Fp       , Gs^Fp       , Gg          , Gs^Fp       , Gg          , Gs^Fp       , Gs^Fp       , Gg          , Gg          , Gg          , Gg          , Gg          , Gg          , Gg          , Gs^Fp       , Gg          , Gg          , Gg          , Gg          , Gg          , Gs^Fp       , Gs^Fp       , Gg          , Gg          , Gg          , Gg          , Gg          , Gg          
Gs^Fp       , Gs^Fp       , Gs^Fp       , Gg          , Hh          , Hh          , Gs^Fp       , Gs^Fp       , Gg          , Gg          , Gg          , Gg          , Cv          , Gs^Fp       , Cv          , Gg          , Gg          , Gg          , Gg          , Gg          , Gg          , Gg          , Gs^Fp       , Gg          , Gs^Fp       , Gg          , Gs^Fp       , Gg          , Gs^Fp       , Gg          , Gg          , Gg          , Gs^Fp       , Gg          , Gg          , Gg          , Gg          
Gg          , Gg          , Gg          , Hh          , Gs^Fp       , Gs^Fp       , Gg          , Gg          , Gs^Fp       , Gg          , Cv          , Cv          , Gg          , Cv          , Gg          , Cv          , Cv          , Cv          , Cv          , Gg          , Gg          , Gs^Fp       , Gs^Fp       , Gs^Fp       , Gg          , Gg          , Gs^Fp       , Gs^Fp       , Hh          , Hh          , Hh          , Hh          , Gs^Fp       , Gg          , Gs^Fp       , Gg          , Gg          
Gs^Fp       , Gs^Fp       , Gg          , Gg          , Hh          , Hh          , Gs^Fp       , Gs^Fp       , Gg          , Gg          , Gg          , Gg          , Gg          , Gg          , Gg          , Gg          , Gg          , Gg          , Gg          , Cv          , Gg          , Gg          , Gg          , Gs^Fp       , Gg          , Gg          , Gg          , Gg^Vh       , Gs^Fp       , Gg          , Gs^Fp       , Gs^Fp       , Gg          , Gg          , Gg          , Gg          , Gg          
Gs^Fp       , Gs^Fp       , Gg          , Gs^Fp       , Gg^Vh       , Gs^Fp       , Gg          , Cv          , Gg          , Gg          , Gs^Fp       , Gg          , Gs^Fp       , Gg          , Cv          , Gg          , Gg          , Gg          , Gg          , Gg          , Gg          , Gg          , Gg          , Gs^Fp       , Gs^Fp       , Gg          , Gg          , Gg          , Gg          , Gg          , Hh          , Gs^Fp       , Gg          , Gg          , Gg          , Gg          , Gg          
Gg          , Gg          , Gs^Fp       , Hh          , Hh          , Gg          , Gg          , Cv          , Gg          , Gs^Fp       , Gs^Fp       , Gs^Fp       , Gg^Vh       , Gs^Fp       , Gg          , Cv          , Gs^Fp       , Gg          , Gg          , Cv          , Gg          , Gg          , Gg          , Gg          , Gs^Fp       , Gs^Fp       , Hh          , Gg          , Gs^Fp       , Gg          , Hh          , Hh          , Gg          , Gg          , Gg          , Gg          , Gg          
Gg          , Gg          , Gs^Fp       , Gs^Fp       , Hh          , Gg          , Cv          , Cv          , Gs^Fp       , Gs^Fp       , Cv          , Gg          , Gg          , Gs^Fp       , Gg          , Gg          , Gs^Fp       , Gg          , Gg          , Cv          , Cv          , Gg          , Gg          , Gg          , Gg          , Hh          , Gs^Fp       , Gs^Fp       , Hh          , Gs^Fp       , Gs^Fp       , Hh          , Gs^Fp       , Gs^Fp       , Gg          , Gs^Fp       , Gs^Fp       
Gg          , Gg          , Gs^Fp       , Gs^Fp       , Gg          , Cv          , Gg          , Gg          , Gs^Fp       , Gs^Fp       , Gs^Fp       , Cv          , Cv          , Re          , Cv          , Cv          , Gs^Fp       , Cv          , Gs^Fp       , Gg          , Gg          , Cv          , Gg          , Gg          , Gs^Fp       , Gs^Fp       , Gs^Fp       , Gg          , Gs^Fp       , Hh          , Gg          , Gg^Vh       , Gg          , Gg          , Gg          , Gs^Fp       , Gs^Fp       
Gg          , Gg          , Cv          , Gs^Fp       , Re          , Gs^Fp       , Re          , Gs^Fp       , Re          , Cv          , Re          , Re          , Cv          , 2 Kv        , Re          , Gg          , Gg          , Cv          , Gs^Fp       , Gg          , Gg          , Gg          , Gg          , Gg^Vh       , Gs^Fp       , Hh          , Hh          , Hh          , Hh          , Hh          , Hh          , Hh          , Hh          , Gg          , Gg          , Re          , Re          
Gg          , Gg          , 1 Kv        , Cv          , Gg          , Re          , Gg          , Re          , Gg          , Re          , Cv          , Re          , Re          , Cv          , Re          , Gs^Fp       , Cv          , Gs^Fp       , Gg          , Gg          , Cv          , Cv          , Gg          , Gs^Fp       , Gg          , Gg          , Gg          , Hh          , Hh          , Gg          , Gg          , Gg          , Gs^Fp       , Gs^Fp       , Re          , Re          , Re          
Re          , Re          , Gs^Fp       , Cv          , Gg          , Gs^Fp       , Gg          , Cv          , Gg          , Gs^Fp       , Cv          , Gs^Fp       , Gs^Fp       , Re          , Re          , Gs^Fp       , Cv          , Gs^Fp       , Gg          , Cv          , Gg          , Gg          , Gs^Fp       , Gs^Fp       , Gg          , Gs^Fp       , Gs^Fp       , Gs^Fp       , Gg          , Gg          , Gg          , Gs^Fp       , Gg          , Gg          , Re          , Gg          , Gg          
Gg          , Gg          , Gg          , Gg          , Gg          , Gg          , Gs^Fp       , Cv          , Gg          , Gs^Fp       , Gg^Vh       , Cv          , Cv          , Cv          , Re          , Cv          , Gg          , Gg          , Gg          , Gg          , Gg          , Gs^Fp       , Gg          , Gs^Fp       , Hh          , Gs^Fp       , Hh          , Gg          , Gs^Fp       , Gg          , Gg          , Gg          , Ce          , Gg          , Re          , Gs^Fp       , Gs^Fp       
Gg          , Gg          , Gg          , Gg          , Gs^Fp       , Gs^Fp       , Gg          , Cv          , Gg          , Gg          , Gg          , Gs^Fp       , Gg          , Gs^Fp       , Re          , Re          , Re          , Gg          , Gg          , Cv          , Gs^Fp       , Gg          , Gg          , Gg          , Gs^Fp       , Hh          , Gg          , Gg          , Gs^Fp       , Gg          , Gg          , Ce          , 5 Ke        , Ce          , Gg          , Gg          , Gg          
Gg          , Gg          , Gg          , Gg^Vh       , Gs^Fp       , Gg          , Gg          , Cv          , Cv          , Gg          , Cv          , Gg          , Gg          , Gg          , Gg          , Re          , Re          , Re          , Cv          , Cv          , Gs^Fp       , Gg          , Gs^Fp       , Gs^Fp       , Hh          , Hh          , Gs^Fp       , Gg^Vh       , Gs^Fp       , Gs^Fp       , Gg          , Ce          , Ce          , Ce          , Gg          , Gs^Fp       , Gs^Fp       
Gs^Fp       , Gs^Fp       , Gs^Fp       , Gs^Fp       , Gg          , Gg          , Gs^Fp       , Gs^Fp       , Gg          , Cv          , Gg          , Gg          , Cv          , Cv          , Cv          , Cv          , Gg          , Re          , Gg          , Gg          , Gg          , Gs^Fp       , Hh          , Hh          , Gs^Fp       , Hh          , Gs^Fp       , Gs^Fp       , Gs^Fp       , Gs^Fp       , Gg          , Gg          , Re          , Gg          , Gg          , Gs^Fp       , Gs^Fp       
Gs^Fp       , Gs^Fp       , Gg          , Gs^Fp       , Gg          , Gg          , Gg          , Gg          , Gg          , Gg          , Gs^Fp       , Gg          , Gs^Fp       , Gg          , Gg          , Gg          , Gg          , Re          , Re          , Gg          , Gg          , Gs^Fp       , Hh          , Gs^Fp       , Gg          , Hh          , Hh          , Gg          , Gg          , Gs^Fp       , Gs^Fp       , Gg          , Re          , Gg          , Gg          , Gg          , Gg          
Hh          , Hh          , Hh          , Gg          , Gg          , Gg          , Gs^Fp       , Gg          , Gs^Fp       , Gg          , Gg          , Gg^Vh       , Hh          , Gg          , Gg          , Gg          , Gg          , Gg          , Gg          , Re          , Re          , Gs^Fp       , Gs^Fp       , Hh          , Hh          , Hh          , Gs^Fp       , Hh          , Gg          , Gg          , Gg          , Gs^Fp       , Gs^Fp       , Re          , Gs^Fp       , Gg          , Gg          
Gg          , Gg          , Gg          , Hh          , Gg          , Gs^Fp       , Gg          , Gs^Fp       , Gg          , Gg          , Gs^Fp       , Gs^Fp       , Gs^Fp       , Hh          , Gg          , Gg          , Gs^Fp       , Gs^Fp       , Gg          , Gs^Fp       , Gs^Fp       , Re          , Re          , Gs^Fp       , Gs^Fp       , Gg          , Gg          , Gs^Fp       , Gg          , Gg          , Gg          , Gs^Fp       , Gs^Fp       , Re          , Gg          , Gg          , Gg          
Gg          , Gg          , Hh          , Gg          , Hh          , Hh          , Gs^Fp       , Gs^Fp       , Gs^Fp       , Gg          , Gg          , Gg          , Hh          , Gg          , Hh          , Hh          , Gs^Fp       , Gg          , Gg          , Gs^Fp       , Gs^Fp       , Gg          , Gg          , Re          , Re          , Gs^Fp       , Gg          , Gs^Fp       , Gg          , Hh          , Gs^Fp       , Gs^Fp       , Gg          , Re          , Gg          , Gg          , Gg          
Gg          , Gg          , Gs^Fp       , Hh          , Hh          , Gg^Vh       , Gs^Fp       , Hh          , Gs^Fp       , Gs^Fp       , Hh          , Hh          , Gg          , Gg          , Gg          , Gg          , Gg^Vh       , Hh          , Gs^Fp       , Gs^Fp       , Gs^Fp       , Gg          , Gs^Fp       , Gg          , Re          , Gg          , Gs^Fp       , Gs^Fp       , Hh          , Gg          , Gg          , Gg          , Gg          , Re          , Gs^Fp       , Gg          , Gg          
Gg          , Gg          , Gg          , Hh          , Gg          , Gs^Fp       , Gg          , Gs^Fp       , Gs^Fp       , Hh          , Hh          , Gs^Fp       , Gg          , Hh          , Hh          , Gg          , Hh          , Gg          , Hh          , Hh          , Gs^Fp       , Gs^Fp       , Gg          , Gs^Fp       , Gg          , Re          , Re          , Gg          , Hh          , Gg^Vh       , Gs^Fp       , Gg          , Re          , Re          , Gs^Fp       , Gg          , Gg          
Gg          , Gg          , Hh          , Hh          , Gs^Fp       , Gs^Fp       , Gs^Fp       , Gs^Fp       , Gs^Fp       , Gg          , Hh          , Hh          , Gg          , Hh          , Gs^Fp       , Hh          , Gg          , Hh          , Gs^Fp       , Gg          , Gg          , Gg          , Gs^Fp       , Gg          , Gg          , Gs^Fp       , Gg          , Re          , Gs^Fp       , Hh          , Gg          , Gs^Fp       , Re          , Gs^Fp       , Gg          , Gg          , Gg          
Gg          , Gg          , Gg          , Gs^Fp       , Gs^Fp       , Gs^Fp       , Gs^Fp       , Hh          , Hh          , Gs^Fp       , Gg          , Hh          , Gg          , Gs^Fp       , Gs^Fp       , Gs^Fp       , Gg          , Gg          , Gg          , Gg          , Gg          , Gg          , Gs^Fp       , Gs^Fp       , Gg          , Gs^Fp       , Gg          , Re          , Re          , Gg          , Gg          , Re          , Gg          , Gs^Fp       , Gs^Fp       , Gg          , Gg          
Gg          , Gg          , Gg          , Gg          , Gs^Fp       , Gs^Fp       , Gg          , Gg          , Gg          , Gg          , Gs^Fp       , Gs^Fp       , Gg          , Gg          , Gg          , Gg          , Ce          , Gg          , Gg          , Gg          , Re          , Gs^Fp       , Re          , Re          , Re          , Gs^Fp       , Re          , Gg          , Ce          , Ce          , Ce          , Re          , Gg          , Gs^Fp       , Gg          , Gg          , Gg          
Gg          , Gg          , Gs^Fp       , Gs^Fp       , Gg          , Gs^Fp       , Hh          , Gg          , Gg          , Gs^Fp       , Gg          , Gg          , Gg          , Gg          , Gg          , Ce          , 3 Ke        , Ce          , Re          , Re          , Gg          , Re          , Gs^Fp       , Gg          , Gs^Fp       , Re          , Gs^Fp       , Re          , Ce          , 4 Ke        , Ce          , Gg          , Gg          , Gs^Fp       , Gg          , Gs^Fp       , Gs^Fp       
Gg          , Gg          , Gs^Fp       , Gg          , Hh          , Hh          , Gg          , Gs^Fp       , Gg          , Gg          , Gg          , Gg          , Gs^Fp       , Gs^Fp       , Re          , Ce          , Ce          , Ce          , Gg          , Gg          , Gs^Fp       , Gg          , Gg          , Gg          , Gs^Fp       , Gs^Fp       , Gg          , Gs^Fp       , Gg          , Ce          , Gg          , Re          , Re          , Gg          , Gg          , Gs^Fp       , Gs^Fp       
Hh          , Hh          , Gg          , Hh          , Hh          , Gg^Vh       , Gs^Fp       , Gs^Fp       , Gs^Fp       , Gs^Fp       , Gs^Fp       , Gg          , Re          , Re          , Gg          , Gg          , Gg          , Gg          , Gg          , Gg          , Gg          , Gg          , Gg          , Gg          , Gs^Fp       , Gg^Vh       , Hh          , Gs^Fp       , Gg          , Gg          , Gs^Fp       , Gg          , Gs^Fp       , Re          , Re          , Gs^Fp       , Gs^Fp       
Gg          , Gg          , Gg          , Gg          , Gs^Fp       , Gs^Fp       , Gg          , Gs^Fp       , Gs^Fp       , Gs^Fp       , Gg          , Re          , Gg          , Gg          , Gg          , Gg          , Gs^Fp       , Hh          , Hh          , Gg^Vh       , Gs^Fp       , Hh          , Gs^Fp       , Hh          , Hh          , Hh          , Gg          , Hh          , Gs^Fp       , Gs^Fp       , Gg          , Gs^Fp       , Gs^Fp       , Gs^Fp       , Re          , Gs^Fp       , Gs^Fp       
Gg          , Gg          , Gs^Fp       , Gg          , Gs^Fp       , Gg          , Gg          , Gg          , Gg          , Gg          , Re          , Re          , Gg          , Gg          , Gs^Fp       , Gg          , Gg          , Gg          , Gs^Fp       , Hh          , Gs^Fp       , Gs^Fp       , Hh          , Hh          , Gg          , Gg          , Hh          , Hh          , Gs^Fp       , Gg          , Gg          , Gg          , Gg          , Gs^Fp       , Gs^Fp       , Re          , Re          
Gg          , Gg          , Gs^Fp       , Gg          , Gs^Fp       , Gg          , Gg          , Gg          , Gg          , Gg          , Re          , Re          , Gg          , Gg          , Gs^Fp       , Gg          , Gg          , Gg          , Gs^Fp       , Hh          , Gs^Fp       , Gs^Fp       , Hh          , Hh          , Gg          , Gg          , Hh          , Hh          , Gs^Fp       , Gg          , Gg          , Gg          , Gg          , Gs^Fp       , Gs^Fp       , Re          , Re          
