border_size=1
usage=map

Rd          , Rd          , Hh          , Gs^Fp       , Mm          , Gs^Fp       , Mm          , Gs^Fp       , Gs^Fp       , Gs^Fp       , Gg          , Gs^Fp       , Hh          , Gs^Fp       , Gs^Fp       , Gs^Fp       , Gs^Fp       , Gs^Fp       , Gs^Fp       , Gs^Fp       , Gs^Fp       , Gs^Fp       
Rd          , Rd          , Hh          , Gs^Fp       , Mm          , Gs^Fp       , Mm          , Gs^Fp       , Gs^Fp       , Gs^Fp       , Gg^Ve       , Gs^Fp       , Hh          , Gs^Fp       , Gs^Fp       , Gs^Fp       , Gs^Fp       , Gs^Fp       , Gs^Fp       , Gs^Fp       , Gs^Fp       , Gs^Fp       
Rd          , Rd          , Rd          , Mm          , Mm          , Mm          , Mm          , Hh          , Hh          , Gs^Fp       , Gs^Fp       , Hh          , Mm          , Mm          , Mm          , Hh          , Hh          , Hh          , Gg^Ve       , Ww          , Ww          , Ww          
Hh          , Hh          , Rd          , Gs^Fp       , Gg          , Mm          , Gg          , Hh          , Gs^Fp       , Gs^Fp       , Gg          , Mm          , Gg          , Mm          , Hh          , Hh          , Ss          , Gs^Fp       , Gs^Fp       , Gs^Fp       , Gs^Fp       , Gs^Fp       
Gs^Fp       , Gs^Fp       , Gg          , Rd          , Rd          , Hh          , Gs^Fp       , Hh          , Gs^Fp       , Gs^Fp       , Rd          , 1 Ke        , Gs^Fp       , Gs^Fp       , Gs^Fp       , Gs^Fp       , Gg          , Hh          , Gs^Fp       , Gs^Fp       , Ww          , Ww          
Gs^Fp       , Gs^Fp       , Gg          , Gs^Fp       , Gs^Fp       , Rd          , Rd          , Hh          , Rd          , Rd          , Gg^Fet      , Gg          , Hh          , Gs^Fp       , Ss          , Gg^Ve       , Gs^Fp       , Ww          , Ss          , Gs^Fp       , Wo          , Wo          
Gs^Fp       , Gs^Fp       , Hh          , Gg          , Gs^Fp       , Rd          , Gg^Ve       , Rd          , Gs^Fp       , Gs^Fp       , Gs^Fp       , Hh          , Mm          , Mm          , Ss          , Gs^Fp       , Gs^Fp       , Ww          , Hh          , Ss          , Ss          , Ss          
Gs^Fp       , Gs^Fp       , Hh          , Gs^Fp       , Hh          , Rd          , Gs^Fp       , Gs^Fp       , Gs^Fp       , Gg          , Hh          , Gs^Fp       , Hh          , Gs^Fp       , Gs^Fp       , Ss          , Ss          , Ss          , Ww          , Gs^Fp       , Ss          , Ss          
Gs^Fp       , Gs^Fp       , Gg          , Gs^Fp       , Gg          , Gg          , Gg          , Gs^Fp       , Mm          , Hh          , Gs^Fp       , Hh          , Ss          , Gs^Fp       , Gg          , Gs^Fp       , Gs^Fp       , Ss          , Gs^Fp       , Ww          , Gs^Fp       , Gs^Fp       
Gg          , Gg          , Gs^Fp       , Gs^Fp       , Gg          , Hh          , Gs^Fp       , Hh          , Gs^Fp       , Gs^Fp       , Ss          , Gs^Fp       , Ss          , Gs^Fp       , Ss          , Gs^Fp       , Ss          , Ss          , Ss          , Ww          , Wo          , Wo          
Gs^Fp       , Gs^Fp       , Gs^Fp       , Gs^Fp       , Gs^Fp       , Gs^Fp       , Gs^Fp       , Hh          , Hh          , Gs^Fp       , Gg          , Ss          , Ss          , Gg          , Gs^Fp       , Ss          , Ss          , Gs^Fp       , Ds          , Ww          , Wo          , Wo          
Gs^Fp       , Gs^Fp       , Gg^Ve       , Gg          , Gg          , Gs^Fp       , Gs^Fp       , Gs^Fp       , Gg^Fet      , Ww          , Ss          , Ss          , Gs^Fp       , Ss          , Gg^Ve       , Gs^Fp       , Ss          , Ds          , Ds          , Wwf         , Wwf         , Wwf         
Gs^Fp       , Gs^Fp       , Hh          , Gs^Fp       , Gg          , Hh          , Ss          , Gs^Fp       , Gg^Ve       , Ds          , Ss          , Hh          , Ss          , Ww          , Gs^Fp       , Ss          , Gs^Fp       , Ds          , Ds          , Ww          , Gs^Fp       , Gs^Fp       
Hh          , Hh          , Gg          , Gs^Fp       , Gs^Fp       , Gs^Fp       , Ss          , Ss          , Ss          , Ww          , Gs^Fp       , Ss          , Hh          , Ss          , Ss          , Ww          , Ww          , Ss          , Wo          , Wo          , Ww          , Ww          
Gs^Fp       , Gs^Fp       , Gs^Fp       , Gs^Fp       , Ss          , Ss          , Ds          , Ds          , Gs^Fp       , Ww          , Rd          , Ds          , Ww          , Ss          , Gg^Fet      , Gg^Fet      , Gg^Fet      , Ww          , Ww          , Ww          , Ss          , Ss          
Gs^Fp       , Gs^Fp       , Wwf         , Wwf         , Wwf         , Ss          , Gg          , Ss          , Ss          , Ss          , Gg^Ve       , Ds          , Ww          , Wwf         , Rr          , Rr          , Cv          , Ss          , Ss          , Gs^Fp       , Ds          , Ds          
Gs^Fp       , Gs^Fp       , Gs^Fp       , Gs^Fp       , Gg^Fet      , Ss          , Gg          , Hh          , Gs^Fp       , Gs^Fp       , Ww          , Gs^Fp       , Ss          , Gg^Fet      , Gg^Fet      , Gg^Fet      , Ss          , Ww          , Gs^Fp       , Ss          , Ds          , Ds          
Gs^Fp       , Gs^Fp       , Gs^Fp       , Gs^Fp       , Ss          , Ss          , Hh          , Ss          , Gs^Fp       , Ww          , Ww          , Gs^Fp       , Ss          , Ss          , Ss          , Ww          , Ww          , Gs^Fp       , Wwf         , Ss          , Gs^Fp       , Gs^Fp       
Gs^Fp       , Gs^Fp       , Gg          , Gg^Fet      , Ss          , Gs^Fp       , Gs^Fp       , Ss          , Ss          , Wwf         , Ds          , Ww          , Ss          , Ss          , Hh          , Gg          , Ww          , Gg          , Ss          , Gs^Fp       , Ss          , Ss          
Gg          , Gg          , Gs^Fp       , Gs^Fp       , Gs^Fp       , Gg          , Gg^Ve       , Gs^Fp       , Ww          , Wwf         , Gs^Fp       , Ss          , Ss          , Ss          , Gs^Fp       , Ds          , Ww          , Ss          , Hh          , Hh          , Ss          , Ss          
Gs^Fp       , Gs^Fp       , Gs^Fp       , Gg          , Ss          , Ss          , Gg          , Gg          , Ww          , Wwf         , Wwf         , Ss          , Gs^Fp       , Wwf         , Ww          , Ss          , Ss          , Gs^Fp       , Gg          , Gg          , Ww          , Ww          
Gs^Fp       , Gs^Fp       , Gs^Fp       , Gg          , Ss          , Ss          , Gg          , Gg          , Ww          , Wwf         , Wwf         , Ss          , Gs^Fp       , Wwf         , Ww          , Ss          , Ss          , Gs^Fp       , Gg          , Gg          , Ww          , Ww          
