border_size=1
usage=map

Aa          , Aa          , Aa          , Mm          , Aa          , Aa          , Aa          , Aa          , Aa          , Aa          , Gg          , Gg          , Gg          , Gg          , Gg          , Gg          , Gg          , Ai          , Gg          , Aa          , Gg          , Aa          , Aa          , Aa          , Aa          , Ai          , Ai          , Gg          , Ai          , Gg          , Gg          , Gg          , Aa^Fpa      , Aa^Fpa      , Aa          , Gg          , Aa          , Gg          , Gg          , Gg          , Gg          , Gg          
Aa          , Aa          , Aa          , Aa          , Aa          , Aa          , Aa          , Aa          , Aa          , Aa          , Gg          , Gg          , Gg          , Gg          , Gg          , Ai          , Ai          , Ai          , Gg          , Aa          , Gg          , Aa          , Aa          , Aa          , Aa          , Ai          , Ai          , Ai          , Ai          , Gg          , Gg          , Gg          , Aa^Fpa      , Aa^Fpa      , Aa          , Gg          , Aa^Vha      , Gg          , Ce          , Gg          , Gg          , Gg          
Aa          , Aa          , Gg          , Gg          , Aa          , Aa          , Aa          , Aa          , Gg          , Gg          , Gg          , Gg          , Gg          , Gg          , Gg          , Ai          , Ai          , Gg          , Gg          , Aa          , Gg          , Aa^Vha      , Gg          , Aa          , Ai          , Ai          , Ai          , Ai          , Ai          , Gg          , Gg          , Gg          , Aa^Fpa      , Gg          , Gg          , Gg          , Gg          , Gg          , Ce          , 1 Ke        , Gg          , Gg          
Aa          , Gg          , Gg          , Gg          , Ha          , Ha          , Aa          , Gg          , Gg          , Gg          , Gg          , Gg          , Gg          , Gg          , Gg          , Gg          , Gg          , Gg          , Aa          , Gg          , Aa          , Aa          , Gg          , Aa          , Ai          , Ai          , Ai          , Aa          , Gg          , Gg          , Aa^Fpa      , Gg          , Aa          , Gg          , Aa^Fpa      , Aa^Fpa      , Aa^Fpa      , Gg          , Aa^Fpa      , Ce          , Gg          , Gg          
Aa          , Gg          , Aa          , Aa          , Ha          , Aa          , Gg          , Gg          , Aa          , Aa          , Gg          , Gg          , Gg          , Gg          , Gg          , Aa          , Aa          , Gg          , Gg          , Gg          , Aa          , Aa          , Aa          , Gg          , Gg          , Ai          , Aa          , Aa          , Gg          , Aa^Fpa      , Aa^Fpa      , Gg          , Aa          , Gg          , Gg          , Gg          , Gg          , Aa          , Aa^Fpa      , Ce          , Gg          , Gg          
Aa          , Aa          , Gg          , Gg          , Ha          , Aa^Vha      , Gg          , Aa          , Gg          , Aa          , Aa          , Aa          , Gg          , Gg          , Aa^Fpa      , Gg          , Gg          , Aa          , Gg          , Aa          , Aa          , Gg          , Aa          , Aa          , Gg          , Gg          , Aa          , Aa          , Gg          , Aa^Fpa      , Gg          , Aa          , Aa^Vha      , Aa          , Aa          , Aa^Fpa      , Aa^Fpa      , Aa          , Aa          , Gg          , Gg          , Gg          
Aa          , Gg          , Gg          , Gg          , Gg          , Ha          , Gg          , Aa          , Gg          , Aa          , Gg          , Gg          , Gg          , Gg          , Gg          , Aa^Fpa      , Gg          , Gg          , Gg          , Gg          , Gg          , Gg          , Gg          , Gg          , Gg          , Gg          , Aa          , Aa          , Aa^Vha      , Gg          , Gg          , Gg          , Aa          , Gg          , Gg          , Aa          , Gg          , Aa          , Aa          , Aa^Vha      , Gg          , Gg          
Aa          , Gg          , Aa          , Ha          , Gg          , Ha          , Aa          , Aa          , Gg          , Gg          , Gg          , Gg          , Ch          , Gg          , Gg          , Gg          , Gg          , Gg          , Gg          , Aa          , Aa          , Gg          , Aa          , Aa          , Aa          , Aa          , Aa          , Aa          , Aa          , Gg          , Gg          , Gg          , Gg          , Gg          , Gg          , Gg          , Gg          , Gg          , Aa^Fpa      , Aa^Fpa      , Gg          , Gg          
Ha          , Aa          , Aa          , Ha          , Ha          , Gg          , Gg          , Gg          , Gg          , Aa          , Gg          , Gg          , Ch          , Gg          , Ch          , Gg          , Gg          , Aa          , Gg          , Gg          , Gg          , Aa          , Aa          , Aa          , Aa          , Aa          , Gg          , Aa          , Aa          , Aa          , Gg          , Gg          , Aa          , Gg          , Gg          , Gg          , Aa          , Gg          , Gg          , Gg          , Gg          , Gg          
Aa          , Aa          , Ha          , Ha          , Aa          , Gg          , Gg          , Gg          , Aa          , Aa          , Gg          , Gg          , Ch          , 4 Kh        , Gg          , Gg          , Gg          , Aa          , Gg          , Gg          , Gg          , Gg          , Aa          , Aa          , Gg          , Gg          , Aa^Fpa      , Gg          , Gg          , Aa          , Gg          , Aa          , Aa          , Gg          , Aa          , Gg          , Gg          , Gg          , Gg          , Aa          , Aa          , Aa          
Ha          , Aa          , Aa          , Aa          , Aa          , Aa          , Ha          , Ha          , Gg          , Gg          , Gg          , Gg          , Gg          , Ch          , Gg          , Gg          , Gg          , Gg          , Gg          , Gg          , Aa          , Gg          , Gg          , Gg          , Gg          , Gg          , Aa^Fpa      , Gg          , Gg          , Aa          , Aa          , Gg          , Gg          , Aa          , Gg          , Gg          , Gg          , Gg          , Gg          , Gg          , Gg          , Gg          
Mm          , Aa          , Hh          , Aa          , Aa          , Ha          , Hh          , Ha          , Aa          , Gg          , Gg          , Gg          , Gg          , Gg          , Gg          , Gg          , Gg          , Aa^Fpa      , Aa^Fpa      , Gg          , Gg          , Aa          , Aa          , Gg          , Gg          , Gg          , Gg          , Aa^Fpa      , Aa^Fpa      , Gg          , Gg          , Aa          , Aa          , Aa          , Gg          , Gg          , Aa          , Aa          , Gg          , Aa          , Aa          , Aa          
Mm          , Aa          , Ha          , Hh          , Hh          , Hh          , Aa          , Ha          , Aa          , Gg          , Gg          , Aa          , Aa          , Gg          , Gg          , Gg          , Aa^Fpa      , Aa^Fpa      , Aa^Fpa      , Gg          , Gg          , Aa          , Aa          , Gg          , Aa          , Gg          , Aa^Vha      , Gg          , Aa^Fpa      , Aa^Fpa      , Aa          , Gg          , Gg          , Gg          , Gg          , Aa          , Gg          , Aa          , Aa^Vha      , Aa          , Aa          , Aa          
Mm          , Ha          , Ha          , Hh          , Ha          , Aa          , Aa          , Ha          , Aa          , Aa          , Gg          , Aa          , Gg          , Aa          , Aa          , Gg          , Aa^Fpa      , Aa^Fpa      , Aa^Fpa      , Gg          , Gg          , Gg          , Gg          , Gg          , Gg          , Gg          , Gg          , Gg          , Gg          , Gg          , Gg          , Aa          , Gg          , Gg          , Gg          , Aa          , Hh          , Gg          , Gg          , Gg          , Aa          , Aa          
Mm          , Mm          , Mm          , Ha          , Ha          , Ha          , Aa^Vha      , Aa          , Aa          , Gg          , Gg          , Gg          , Aa          , Aa          , Gg          , Gg          , Gg          , Gg          , Gg          , Aa^Fpa      , Gg          , Gg          , Gg          , Gg          , Gg          , Gg          , Aa          , Gg          , Gg          , Gg          , Gg          , Aa          , Gg          , Gg          , Hh          , Hh          , Aa          , Aa          , Gg          , Aa          , Aa          , Aa          
Mm          , Mm          , Mm          , Mm          , Ha          , Ha          , Aa          , Aa          , Gg          , Gg          , Gg          , Gg          , Ai          , Gg          , Gg          , Gg          , Gg          , Gg          , Gg          , Gg          , Gg          , Gg          , Gg          , Aa          , Aa          , Gg          , Gg          , Gg          , Gg          , Gg          , Gg          , Gg          , Gg          , Hh          , Hh          , Hh          , Gg          , Gg          , Gg          , Gg          , Aa          , Aa          
Mm          , Mm          , Ha          , Mm          , Ha          , Ha          , Ha          , Aa          , Gg          , Gg          , Ai          , Ai          , Ai          , Gg          , Gg          , Gg          , Aa          , Gg          , Gg          , Gg          , Aa          , Gg          , Gg          , Gg          , Gg          , Aa          , Gg          , Gg          , Aa^Fpa      , Aa          , Gg          , Gg          , Gg          , Hh          , Hh          , Hh          , Hh          , Gg          , Gg          , Gg          , Gg          , Gg          
Mm          , Mm          , Ha          , Mm          , Mm          , Aa          , Ha          , Aa          , Aa          , Aa          , Aa          , Ai          , Ai          , Gg          , Gg          , Gg          , Aa^Vha      , Aa          , Gg          , Gg          , Aa          , Gg          , Gg          , Gg          , Gg          , Gg          , Aa^Fpa      , Aa^Fpa      , Aa^Fpa      , Gg          , Aa          , Gg          , Gg          , Gg          , Gg          , Hh          , Gg          , Gg          , Gg          , Gg          , Gg          , Gg          
Mm          , Ha          , Ha          , Mm          , Ha          , Ha          , Ha          , Ha          , Gg          , Aa          , Gg          , Gg          , Gg          , Gg          , Gg          , Gg          , Gg          , Gg          , Aa          , Gg          , Gg          , Aa          , Aa          , Gg          , Gg          , Gg          , Aa^Fpa      , Aa^Fpa      , Aa^Fpa      , Aa          , Gg          , Aa          , Gg          , Gg          , Gg          , Gg          , Gg          , Aa          , Gg          , Gg          , Aa          , Aa          
Mm          , Mm          , Mm          , Mm          , Ha          , Ha          , Aa          , Aa          , Gg          , Aa          , Aa          , Gg          , Aa          , Gg          , Gg          , Gg          , Gg          , Aa          , Aa          , Aa          , Gg          , Gg          , Aa          , Gg          , Gg          , Gg          , Gg          , Aa^Fpa      , Gg          , Gg          , Aa^Fpa      , Gg          , Aa          , Gg          , Gg          , Gg          , Aa          , Aa          , Aa          , Aa          , Gg          , Gg          
Mm          , Mm          , Mm          , Mm          , Ha          , Aa          , Aa          , Aa          , Gg          , Aa          , Aa          , Aa          , Gg          , Gg          , Gg          , Gg          , Gg          , Gg          , Aa          , Aa          , Gg          , Gg          , Gg          , Aa          , Aa          , Gg          , Gg          , Gg          , Gg          , Gg          , Gg          , Gg          , Gg          , Aa          , Gg          , Gg          , Ai          , Ai          , Ai          , Gg          , Aa          , Aa          
Mm          , Mm          , Mm          , Ha          , Aa^Vha      , Aa          , Aa          , Gg          , Gg          , Aa          , Aa          , Aa          , Gg          , Gg          , Gg          , Gg          , Gg          , Gg          , Gg          , Gg          , Gg          , Gg          , Gg          , Gg          , Aa          , Gg          , Gg          , Aa          , Aa          , Gg          , Gg          , Gg          , Gg          , Aa          , Gg          , Gg          , Ai          , Ai          , Gg          , Gg          , Aa          , Aa          
Ha          , Ha          , Mm          , Ha          , Aa          , Ha          , Aa          , Aa          , Gg          , Aa          , Gg          , Gg          , Ha          , Ha          , Ha          , Ha          , Gg          , Gg          , Gg          , Aa          , Gg          , Aa          , Gg          , Gg          , Gg          , Aa          , Aa^Vha      , Gg          , Gg          , Aa          , Gg          , Gg          , Gg          , Aa          , Aa          , Aa^Fpa      , Aa^Fpa      , Ai          , Aa          , Aa          , Aa          , Aa          
Ha          , Ha          , Mm          , Mm          , Aa          , Ha          , Aa          , Gg          , Gg          , Aa          , Gg          , Gg          , Ha          , Mm          , Ha          , Ha          , Gg          , Gg          , Gg          , Gg          , Gg          , Gg          , Aa          , Aa          , Aa          , Gg          , Gg          , Aa          , Aa          , Gg          , Gg          , Gg          , Gg          , Gg          , Gg          , Gg          , Aa^Fpa      , Gg          , Aa          , Aa^Vha      , Aa          , Aa          
Mm          , Mm          , Mm          , Mm          , Ha          , Ha          , Gg          , Aa          , Aa          , Gg          , Gg          , Ha          , Ha          , Mm          , Mm          , Ha          , Ha          , Gg          , Gg          , Gg          , Aa          , Aa          , Gg          , Aa          , Aa          , Gg          , Gg          , Gg          , Gg          , Gg          , Gg          , Gg          , Gg          , Gg          , Gg          , Gg          , Aa^Fpa      , Gg          , Gg          , Gg          , Gg          , Gg          
Ha          , Ha          , Ha          , Ha          , Ha          , Ha          , Gg          , Gg          , Aa          , Aa          , Gg          , Aa          , Gg          , Ha          , Ha          , Ha          , Gg          , Gg          , Gg          , Aa          , Aa          , Aa          , Aa          , Aa          , Gg          , Aa          , Aa          , Gg          , Gg          , Gg          , Gg          , Ch          , Ch          , Gg          , Gg          , Gg          , Gg          , Gg          , Gg          , Gg          , Gg          , Gg          
Mm          , Mm          , Mm          , Ha          , Ha          , Ha          , Ha          , Gg          , Gg          , Gg          , Gg          , Gg          , Gg          , Ha          , Gg          , Gg          , Gg          , Gg          , Gg          , Aa          , Gg          , Aa          , Aa          , Aa          , Gg          , Aa          , Gg          , Gg          , Gg          , Gg          , Gg          , Ch          , 3 Kh        , Ch          , Ch          , Gg          , Gg          , Gg          , Gg          , Gg          , Aa          , Aa          
Mm          , Mm          , Mm          , Ha          , Ha          , Ha          , Aa          , Gg          , Gg          , Gg          , Gg          , Gg          , Gg          , Gg          , Gg          , Gg          , Gg          , Gg          , Gg          , Gg          , Gg          , Gg          , Gg          , Aa          , Aa          , Gg          , Gg          , Gg          , Aa          , Aa          , Aa          , Gg          , Gg          , Gg          , Gg          , Gg          , Gg          , Gg          , Aa          , Aa          , Aa          , Aa          
Mm          , Mm          , Ha          , Ha          , Mm          , Ha          , Ha          , Aa          , Gg          , Gg          , Gg          , Aa^Vea      , Gg          , Aa          , Aa          , Gg          , Gg          , Ha          , Ha          , Gg          , Gg          , Aa^Vea      , Gg          , Gg          , Gg          , Gg          , Gg          , Gg          , Gg          , Gg          , Gg          , Aa          , Gg          , Gg          , Aa          , Gg          , Gg          , Aa          , Gg          , Gg          , Gg          , Gg          
Mm          , Mm          , Ha          , Ha          , Ha          , Ha          , Ha          , Aa          , Gg          , Gg          , Aa          , Gg          , Gg          , Aa          , Gg          , Gg          , Gg          , Ha          , Ha          , Ha          , Gg          , Gg          , Gg          , Gg          , Gg          , Gg          , Gg          , Gg          , Gg          , Gg          , Gg          , Gg          , Ai          , Aa          , Gg          , Aa          , Gg          , Aa          , Gg          , Gg          , Gg          , Gg          
Mm          , Mm          , Ha          , Ha          , Ha          , Mm          , Ha          , Ha          , Aa          , Gg          , Gg          , Aa          , Gg          , Aa          , Gg          , Gg          , Gg          , Ha          , Ha          , Ha          , Ha          , Gg          , Ha          , Gg          , Gg          , Gg          , Gg          , Ai          , Ai          , Gg          , Ai          , Ai          , Ai          , Gg          , Gg          , Gg          , Gg          , Gg          , Hh          , Hh          , Gg          , Gg          
Mm          , Mm          , Mm          , Mm          , Mm          , Ha          , Ha          , Aa          , Ha          , Gg          , Gg          , Gg          , Gg          , Gg          , Aa          , Gg          , Gg          , Gg          , Gg          , Ha          , Gg          , Ha          , Ha          , Ha          , Ha          , Gg          , Gg          , Ai          , Ai          , Ai          , Ai          , Ai          , Ai          , Gg          , Gg          , Gg          , Hh          , Gg          , Hh          , Hh          , Gg          , Gg          
Mm          , Mm          , Mm          , Mm          , Mm          , Ha          , Ha          , Ha          , Aa          , Gg          , Aa          , Gg          , Gg          , Gg          , Gg          , Aa          , Gg          , Gg          , Gg          , Gg          , Ha          , Mm          , Mm          , Ha          , Ha          , Ha          , Gg          , Gg          , Gg          , Ai          , Ai          , Gg          , Gg          , Gg          , Gg          , Gg          , Hh          , Hh          , Hh          , Hh          , Hh          , Gg          
Mm          , Mm          , Ha          , Mm          , Mm          , Mm          , Ha          , Mm          , Mm          , Gg          , Aa          , Aa          , Aa          , Aa          , Gg          , Gg          , Aa          , Gg          , Gg          , Aa          , Aa          , Ha          , Mm          , Mm          , Ha          , Ha          , Ha          , Gg          , Gg          , Ai          , Ai          , Gg          , Aa          , Gg          , Gg          , Aa^Vea      , Gg          , Gg          , Gg          , Hh          , Gg          , Gg          
Mm          , Mm          , Mm          , Mm          , Mm          , Mm          , Mm          , Ha          , Ha          , Ha          , Ha          , Aa          , Aa          , Aa          , Aa          , Aa          , Aa          , Gg          , Aa          , Aa          , Aa          , Ha          , Mm          , Mm          , Mm          , Ha          , Ha          , Ha          , Aa          , Gg          , Gg          , Gg          , Gg          , Gg          , Gg          , Gg          , Aa          , Gg          , Aa          , Aa          , Gg          , Gg          
Mm          , Mm          , Ha          , Mm          , Mm          , Mm          , Mm          , Mm          , Mm          , Ha          , Ha          , Ce          , Ce          , Ce          , Ce          , Aa          , Ha          , Aa          , Aa          , Aa          , Gg          , Ha          , Ha          , Mm          , Mm          , Mm          , Ha          , Ha          , Gg          , Gg          , Aa          , Gg          , Aa          , Gg          , Aa          , Gg          , Gg          , Gg          , Aa          , Aa          , Gg          , Gg          
Mm          , Mm          , Mm          , Ha          , Ha          , Ha          , Ha          , Mm          , Mm          , Mm          , Ha          , Ha          , Ha          , 2 Ke        , Mm          , Ce          , Aa          , Ha          , Aa          , Gg          , Gg          , Gg          , Gg          , Ha          , Ha          , Mm          , Mm          , Ha          , Gg          , Gg          , Aa          , Gg          , Aa          , Aa          , Ha          , Aa          , Ha          , Gg          , Gg          , Ha          , Gg          , Gg          
Mm          , Mm          , Mm          , Mm          , Ha          , Mm          , Mm          , Ha          , Mm          , Mm          , Mm          , Ha          , Ha          , Mm          , Mm          , Mm          , Mm          , Aa          , Ha          , Ha          , Ha          , Aa^Vea      , Ha          , Ha          , Ha          , Mm          , Ha          , Ha          , Aa          , Gg          , Ha          , Ha          , Hh          , Ha          , Hh          , Ha          , Hh          , Ha          , Aa          , Ha          , Aa          , Hh          
Mm          , Mm          , Mm          , Mm          , Mm          , Ha          , Mm          , Mm          , Mm          , Mm          , Ha          , Mm          , Mm          , Ha          , Ha          , Ha          , Mm          , Aa          , Mm          , Ha          , Mm          , Ha          , Ha          , Ha          , Mm          , Ha          , Mm          , Ha          , Ha          , Aa          , Ha          , Ha          , Ha          , Ha          , Hh          , Hh          , Hh          , Gg          , Gg          , Gg          , Hh          , Gg          
Mm          , Mm          , Mm          , Mm          , Mm          , Mm          , Mm          , Mm          , Ha          , Mm          , Ha          , Ha          , Ha          , Mm          , Mm          , Ha          , Ha          , Mm          , Mm          , Mm          , Mm          , Mm          , Ha          , Ha          , Ha          , Mm          , Mm          , Ha          , Ha          , Mm          , Ha          , Mm          , Ha          , Ha          , Hh          , Hh          , Hh          , Hh          , Hh          , Hh          , Gg          , Gg          
Mm          , Mm          , Mm          , Mm          , Mm          , Mm          , Mm          , Mm          , Mm          , Mm          , Mm          , Mm          , Mm          , Mm          , Ha          , Mm          , Ha          , Ha          , Mm          , Mm          , Ha          , Mm          , Mm          , Ha          , Mm          , Ha          , Mm          , Ha          , Mm          , Ha          , Mm          , Ha          , Mm          , Ha          , Ha          , Ha          , Ha          , Ha          , Ha          , Hh          , Ha          , Gg          
Mm          , Mm          , Mm          , Mm          , Mm          , Mm          , Mm          , Mm          , Mm          , Mm          , Mm          , Mm          , Mm          , Mm          , Ha          , Mm          , Ha          , Ha          , Mm          , Mm          , Ha          , Mm          , Mm          , Ha          , Mm          , Ha          , Mm          , Ha          , Mm          , Ha          , Mm          , Ha          , Mm          , Mm          , Mm          , Ha          , Mm          , Ha          , Ha          , Ha          , Ha          , Ha          
