border_size=1
usage=map

Rd          , Rd          , Rd          , Mm          , Mm          , Mm          , Mm          , Hh          , Hh          , Gs^Fp       , Gs^Fp       , Hh          , Mm          , Mm          , Mm          , Hh          , Hh          , Hh          , Gg          , Ww          , Ww          , Ss          , Gs^Fp       , Ss          , Gg          , Gg          , Gs^Fp       , Ww          , Wo          , Wo          , Ww          , Ww          
Rd          , Rd          , Rd          , Mm          , Mm          , Mm          , Mm          , Hh          , Hh          , Gs^Fp       , Gs^Fp       , Hh          , Mm          , Mm          , Mm          , Hh          , Hh          , Hh          , Gg^Ve       , Ww          , Ww          , Ss          , Gs^Fp       , Ss          , Gg          , Gg          , Gs^Fp       , Ww          , Wo          , Wo          , Ww          , Ww          
Hh          , Hh          , Rd          , Gs^Fp       , Gg          , Mm          , Gg          , Hh          , Gs^Fp       , Gs^Fp       , Cv          , Mm          , Cv          , Mm          , Hh          , Hh          , Ss          , Gs^Fp       , Gs^Fp       , Gs^Fp       , Gs^Fp       , Gs^Fp       , Ww          , Gs^Fp       , Ds          , Ds          , Ww          , Wo          , Ww          , Ww          , Ss          , Ss          
Gs^Fp       , Gs^Fp       , Gg          , Rd          , Rd          , Hh          , Gs^Fp       , Hh          , Gs^Fp       , Gs^Fp       , Gs^Fp       , 1 Kv        , Gs^Fp       , Gs^Fp       , Gs^Fp       , Gs^Fp       , Gg          , Hh          , Gs^Fp       , Gs^Fp       , Ww          , Ww          , Gs^Fp       , Gs^Fp       , Ss          , Ww          , Ss          , Gs^Fp       , Ss          , Ss          , Ds          , Ds          
Gs^Fp       , Gs^Fp       , Gg          , Gs^Fp       , Gs^Fp       , Rd          , Gg          , Hh          , Gg          , Gs^Fp       , Gg^Fet      , Cv          , Hh          , Gs^Fp       , Ss          , Gg^Ve       , Gs^Fp       , Ww          , Ss          , Gs^Fp       , Wo          , Wo          , Ss          , Gs^Fp       , Ww          , Ss          , Ww          , Gs^Fp       , Ds          , Ds          , Gg^Ve       , Gg          
Gs^Fp       , Gs^Fp       , Hh          , Gg          , Gs^Fp       , Rd          , Gg^Ve       , Gg          , Gs^Fp       , Gs^Fp       , Gs^Fp       , Hh          , Mm          , Mm          , Ss          , Gs^Fp       , Gs^Fp       , Ww          , Hh          , Ss          , Ss          , Ss          , Hh          , Ww          , Gs^Fp       , Ww          , Wwf         , Gs^Fp       , Ss          , Gs^Fp       , Ss          , Ss          
Gs^Fp       , Gs^Fp       , Hh          , Gs^Fp       , Hh          , Rd          , Gs^Fp       , Gs^Fp       , Gs^Fp       , Gg          , Hh          , Gs^Fp       , Hh          , Gs^Fp       , Gs^Fp       , Ss          , Ss          , Ss          , Ww          , Gs^Fp       , Ss          , Gs^Fp       , Gg^Ve       , Gg          , Ds          , Gs^Fp       , Gs^Fp       , Gs^Fp       , Hh          , Hh          , Gs^Fp       , Gs^Fp       
Gs^Fp       , Gs^Fp       , Gg          , Gs^Fp       , Gg          , Rd          , Rd          , Gs^Fp       , Gg          , Hh          , Gs^Fp       , Hh          , Ss          , Gs^Fp       , Gg          , Gs^Fp       , Gs^Fp       , Ss          , Gs^Fp       , Ww          , Gs^Fp       , Gs^Fp       , Gs^Fp       , Gg          , Ss          , Ss          , Gg          , Hh          , Mm          , Mm          , Mm          , Mm          
Gg          , Gg          , Gs^Fp       , Gs^Fp       , Gg          , Hh          , Gs^Fp       , Rd          , Gs^Fp       , Gs^Fp       , Gg          , Gs^Fp       , Gg          , Gs^Fp       , Gg          , Gs^Fp       , Ss          , Ss          , Ss          , Ww          , Wo          , Hh          , Gs^Fp       , Ss          , Gs^Fp       , Gg          , Gg^Fet      , Hh          , Hh          , Hh          , Hh          , Hh          
Gs^Fp       , Gs^Fp       , Gs^Fp       , Gs^Fp       , Gs^Fp       , Gs^Fp       , Gs^Fp       , Rd          , Rd          , Gs^Fp       , Gg          , Gg          , Gg          , Gg          , Gg          , Ss          , Ss          , Gs^Fp       , Ds          , Ww          , Wo          , Ww          , Ss          , Ds          , Ds          , Gg          , Hh          , Hh          , Ss          , Gs^Fp       , Gs^Fp       , Gs^Fp       
Gs^Fp       , Gs^Fp       , Gg^Ve       , Gg          , Gg          , Gs^Fp       , Gs^Fp       , Gs^Fp       , Gg^Fet      , Rd          , Gg          , Ss          , Gs^Fp       , Gg          , Gg^Ve       , Gs^Fp       , Ss          , Ds          , Ds          , Wwf         , Wwf         , Hh          , Gg^Ve       , Wwf         , Ds          , Gs^Fp       , Gg          , Ss          , Cv          , Ss          , Gs^Fp       , Gs^Fp       
Gs^Fp       , Gs^Fp       , Hh          , Gs^Fp       , Gg          , Hh          , Ss          , Gs^Fp       , Gg^Ve       , Rd          , Ss          , Hh          , Ss          , Ww          , Gs^Fp       , Ss          , Gs^Fp       , Ds          , Ds          , Ww          , Gs^Fp       , Gg^Fet      , Ss          , Ss          , Ds          , Gg          , Gg          , Ss          , 2 Kv        , Gs^Fp       , Gs^Fp       , Gs^Fp       
Hh          , Hh          , Gg          , Gs^Fp       , Gs^Fp       , Gs^Fp       , Ds          , Gg          , Gg          , Rd          , Gs^Fp       , Ss          , Hh          , Ss          , Ss          , Ww          , Ww          , Ss          , Wo          , Wo          , Ww          , Wwf         , Gs^Fp       , Ww          , Ww          , Ss          , Mm          , Cv          , Gg          , Cv          , Gs^Fp       , Gs^Fp       
Gs^Fp       , Gs^Fp       , Gs^Fp       , Cv          , Gg          , Gg          , Ds          , Ds          , Gs^Fp       , Rd          , Rd          , Wwf         , Ww          , Ss          , Cv          , Kv          , Cv          , Ww          , Ww          , Ww          , Ss          , Ss          , Hh          , Hh          , Ww          , Mm          , Hh          , Ss          , Gg          , Gs^Fp       , Hh          , Hh          
Gs^Fp       , Gs^Fp       , Cv          , 4 Kv        , Cv          , Gg          , Gg          , Ss          , Ss          , Ss          , Gg^Ve       , Ds          , Ww          , Wwf         , Kv          , Gg          , Kv          , Ss          , Ss          , Gs^Fp       , Ds          , Hh          , Gs^Fp       , Hh          , Gs^Fp       , Mm          , Gs^Fp       , Gs^Fp       , Gg          , Gg^Ve       , Hh          , Hh          
Gs^Fp       , Gs^Fp       , Gs^Fp       , Gg          , Gg          , Gg          , Gg          , Hh          , Gs^Fp       , Gs^Fp       , Ww          , Gs^Fp       , Ss          , Gg          , Ww          , Cv          , Ss          , Ww          , Gs^Fp       , Ss          , Ds          , Gg^Ve       , Hh          , Hh          , Ww          , Ww          , Ss          , Gg^Fet      , Hh          , Hh          , Gs^Fp       , Gs^Fp       
Gs^Fp       , Gs^Fp       , Gs^Fp       , Gs^Fp       , Gg          , Gg          , Hh          , Ss          , Gs^Fp       , Ww          , Ww          , Gs^Fp       , Ss          , Ss          , Ss          , Ww          , Ww          , Rd          , Wwf         , Ss          , Rd          , Gg          , Rd          , Ww          , Ww          , Ss          , Gs^Fp       , Hh          , Mm          , Mm          , Gs^Fp       , Gs^Fp       
Gs^Fp       , Gs^Fp       , Gg          , Gg^Fet      , Gg          , Gs^Fp       , Gs^Fp       , Ss          , Ss          , Wwf         , Ds          , Ww          , Ss          , Ss          , Hh          , Gg          , Ww          , Gg          , Ss          , Rd          , Ss          , Gs^Fp       , Gs^Fp       , Ww          , Gg          , Ss          , Gg          , Mm          , Mm          , Hh          , Gs^Fp       , Gs^Fp       
Gg          , Gg          , Gs^Fp       , Gs^Fp       , Gs^Fp       , Gg          , Gg^Ve       , Gs^Fp       , Ww          , Wwf         , Gs^Fp       , Ss          , Ss          , Ss          , Gs^Fp       , Ds          , Ww          , Ss          , Hh          , Hh          , Ss          , Ss          , Gs^Fp       , Ss          , Gs^Fp       , Hh          , Gs^Fp       , Mm          , Hh          , Hh          , Gs^Fp       , Gs^Fp       
Gs^Fp       , Gs^Fp       , Gs^Fp       , Gg          , Ss          , Ss          , Gg          , Gg          , Ww          , Wwf         , Wwf         , Ss          , Gs^Fp       , Wwf         , Ww          , Ss          , Ss          , Gs^Fp       , Gg          , Gg          , Ww          , Gs^Fp       , Gg^Fet      , Rd          , Gg          , Gg          , Gg          , Gg          , Gg          , Gs^Fp       , Gs^Fp       , Gs^Fp       
Gs^Fp       , Gs^Fp       , Gg          , Gg          , Ds          , Ss          , Ww          , Ww          , Ww          , Ss          , Ss          , Hh          , Hh          , Gs^Fp       , Hh          , Gs^Fp       , Gs^Fp       , Gs^Fp       , Ww          , Ss          , Ss          , Ss          , Rd          , Gg^Ve       , Gs^Fp       , Gs^Fp       , Gg          , Gs^Fp       , Gs^Fp       , Gg          , Gg          , Gg          
Ss          , Ss          , Ss          , Ds          , Ds          , Ww          , Gs^Fp       , Ww          , Ss          , Ss          , Ww          , Ss          , Ss          , Gs^Fp       , Ds          , Gg          , Ss          , Ss          , Gs^Fp       , Gs^Fp       , Ss          , Ss          , Gg          , Gg          , Rd          , Rd          , Gg          , Hh          , Hh          , Gs^Fp       , Gg          , Gg          
Gs^Fp       , Gs^Fp       , Ww          , Ww          , Ww          , Ww          , Ww          , Ww          , Ss          , Ww          , Gg          , Gs^Fp       , Ss          , Gg          , Gs^Fp       , Ss          , Gs^Fp       , Gs^Fp       , Hh          , Hh          , Ss          , Gs^Fp       , Gs^Fp       , Gg          , Gs^Fp       , Gs^Fp       , Gs^Fp       , Rd          , Gs^Fp       , Gg          , Gs^Fp       , Gs^Fp       
Gs^Fp       , Gs^Fp       , Ww          , Gs^Fp       , Wwf         , Ss          , Ss          , Ss          , Ss          , Ss          , Gs^Fp       , Ds          , Ss          , Ss          , Ww          , Gg^Ve       , Ss          , Hh          , Mm          , Mm          , Hh          , Hh          , Hh          , Gs^Fp       , Gg          , Hh          , Gs^Fp       , Gg          , Gs^Fp       , Gs^Fp       , Gs^Fp       , Gs^Fp       
Gs^Fp       , Gs^Fp       , Ww          , Ww          , Gg^Ve       , Ss          , Ss          , Ss          , Ss          , Gs^Fp       , Ss          , Ss          , Hh          , Ss          , Gg          , Gs^Fp       , Ss          , Hh          , Mm          , Mm          , Cv          , Gs^Fp       , Cv          , Gg          , Gg^Ve       , Gs^Fp       , Gs^Fp       , Rd          , Rd          , Gg          , Gs^Fp       , Gs^Fp       
Gs^Fp       , Gs^Fp       , Ww          , Ww          , Gs^Fp       , Gg          , Ss          , Ss          , Ds          , Gg          , Ss          , Hh          , Gg^Fet      , Ds          , Ds          , Gg          , Ss          , Mm          , Gs^Fp       , Gs^Fp       , Gs^Fp       , 3 Kv        , Gg          , Gs^Fp       , Gs^Fp       , Gs^Fp       , Gg          , Gg          , Gg          , Rd          , Gs^Fp       , Gs^Fp       
Gs^Fp       , Gs^Fp       , Gs^Fp       , Ss          , Gs^Fp       , Ss          , Ss          , Ds          , Ss          , Ss          , Gs^Fp       , Gs^Fp       , Hh          , Hh          , Gg          , Gs^Fp       , Gg          , Gs^Fp       , Hh          , Gg          , Gs^Fp       , Cv          , Gg          , Hh          , Gg          , Gg          , Hh          , Gg          , Gg          , Rd          , Rd          , Rd          
Gg          , Gg          , Gs^Fp       , Wwf         , Ss          , Ss          , Gs^Fp       , Hh          , Wwf         , Hh          , Gg^Ve       , Hh          , Ss          , Gs^Fp       , Gs^Fp       , Gg          , Gs^Fp       , Hh          , Gg          , Gg          , Gg          , Gg          , Gg          , Gg          , Gs^Fp       , Gs^Fp       , Gg          , Gs^Fp       , Gs^Fp       , Gs^Fp       , Rd          , Rd          
Gs^Fp       , Gs^Fp       , Gs^Fp       , Ww          , Gs^Fp       , Ss          , Gs^Fp       , Ss          , Ww          , Ss          , Gs^Fp       , Gs^Fp       , Gs^Fp       , Ss          , Ss          , Gs^Fp       , Gs^Fp       , Gg          , Gg          , Gg          , Gg          , Gs^Fp       , Gs^Fp       , Gs^Fp       , Gs^Fp       , Gs^Fp       , Gg          , Gs^Fp       , Hh          , Hh          , Rd          , Rd          
Gs^Fp       , Gs^Fp       , Ww          , Ww          , Gs^Fp       , Ss          , Ww          , Wwf         , Gs^Fp       , Gs^Fp       , Gs^Fp       , Gg          , Gs^Fp       , Ss          , Gs^Fp       , Ss          , Gs^Fp       , Gs^Fp       , Gs^Fp       , Gs^Fp       , Gs^Fp       , Gg          , Gs^Fp       , Gg^Ve       , Gs^Fp       , Gs^Fp       , Gg          , Gs^Fp       , Gs^Fp       , Gs^Fp       , Rd          , Rd          
Gs^Fp       , Gs^Fp       , Ww          , Ww          , Gs^Fp       , Ss          , Ww          , Wwf         , Gs^Fp       , Gs^Fp       , Gs^Fp       , Gg          , Gs^Fp       , Ss          , Gs^Fp       , Ss          , Gs^Fp       , Gs^Fp       , Gs^Fp       , Gs^Fp       , Gs^Fp       , Gg          , Gs^Fp       , Gg          , Gs^Fp       , Gs^Fp       , Gg          , Gs^Fp       , Gs^Fp       , Gs^Fp       , Rd          , Rd          
