Gg, Gg, Gg, Gg, Gg, Gg, Gg, Gg, Gg, Gg, Gg, Gg, Gg, Gg, Gg, Gg, Gg, Gg, Gg, Gg, Gg, Gg, Gg, Gg, Gg, Gg, Gg, Gg, Gg, Gg, Gg, Gg, Gs, Gg, Gg, Gg
Gg, Gg, Gg, Gg, Gg, Gg, Gg, Gg, Gg, Gg, Gg, Gg, Gg, Gg, Gg, Gg, Gs, Gg, Gg, Gg, Gg, Gg, Gg, Gg, Gg, Gg, Gg, Gg, Gg, Gg, Gs, Gg, Gs, Gg, Gs, Gs
Rr, Gg, Gs, Gg, Gg, Gg, Gg, Gg, Gg, Gg, Gg, Gg, Gg, Gg, Gg, Gg, Gs, Gg, Gg, Gg, Hh, Gg, Gg, Gg, Gg, Gg, Gg, Gg, Gs, Gs, Gg, Gg, Gg, Gg, Gg, Gg
Gg, Rr, Rr, Gs, Gs, Gg, Gg, Gg, Gg, Gg, Gg, Gg, Gg, Gg, Gs, Gs, Gg, Gs, Gg, Gg, Gg, Hh, Hh, Gg, Hh, Gg, Gg, Gs, Gg, Gg, Gg, Gg, Gg, Gg, Gg, Gg
Gg, Gg, Gs, Rr, Rr, Gs, Gg, Gg, Gg, Hh, Gg, Gs, Gs, Gg, Gs, Gg, Gg, Gs, Gg, Gg, Gg, Hh, Hh, Hh, Hh, Gg, Gg, Gg, Gg, Gg, Gg, Gg, Gs, Gg, Gg, Gg
Gg, Gg, Gg, Gg, Hh, Rr, Rr, Hh, Hh, Hh, Gg, Gg, Gg, Gg, Gg, Gs, Gg, Gs, Gg, Gg, Gg, Gg, Hh, Gg, Hh, Hh, Hh, Gg, Gg, Gg, Gg, Gg, Gg, Gg, Hh, Hh
Gg, Gg, Gg, Gg, Hh, Hh, Hh, Rr, Rr, Hh, Hh, Gg, Gg, Gg, Gg, Gg, Gg, Gg, Gg, Gs, Gg, Gg, Gg, Hh, Hh, Gg, Gg, Gg, Gg, Gg, Gg, Gs, Gg, Gg, Gg, Gg
Gg, Gg, Gg, Hh, Gg, Gg, Gg, Gg, Gg, Rr, Rr, Gg, Gs, Gg, Gg, Gg, Gg, Gg, Gg, Gg, Gg, Gg, Gg, Hh, Gg, Gg, Gg, Gg, Gg, Gg, Gs, Gs, Gs, Gg, Gg, Gg
Gg, Gg, Gg, Gg, Hh, Hh, Hh, Gg, Gg, Hh, Gg, Rr, Rr, Gs, Gs, Gg, Gg, Gg, Gg, Gg, Gg, Gg, Gg, Gg, Gg, Gg, Gs, Gg, Gg, Gs, Gg, Gs, Gg, Gs, Gg, Gg
Gg, Gg, Gg, Hh, Gg, Gg, Gg, Gg, Gg, Gg, Gg, Gg, Gg, Rr, Rr, Gs, Gg, Gg, Gg, Gs, Gs, Gg, Gg, Gg, Gs, Gs, Gs, Gg, Gg, Gg, Gg, Gg, Gg, Gg, Gg, Gg
Gg, Gg, Gg, Gg, Gg, Gg, Gg, Gg, Gg, Gg, Gg, Gg, Gg, Gg, Gg, Rr, Rr, Gg, Gg, Gg, Gg, Gs, Gs, Gs, Gs, Gs, Gg, Gg, Gg, Gg, Gs, Gg, Gs, Gs, Gg, Gg
Gg, Gg, Gg, Gg, Gg, Gg, Gg, Gg, Gg, Gg, Gs, Hh, Hh, Gg, Gg, Gg, Gg, Rr, Rr, Gg, Gg, Gg, Gg, Gs, Gg, Gs, Gg, Gg, Gs, Gs, Gg, Gg, Gg, Gg, Gg, Gg
Gg, Gg, Gg, Gg, Gg, Gg, Gg, Gg, Gg, Gs, Gg, Gg, Hh, Hh, Gg, Gg, Gg, Gg^Vh, Gg, Rr, Rr, Gg^Vh, Gg, Gg, Gg, Gg, Gg, Gg, Gs, Gg, Gg, Gg, Gg, Gg, Gg, Gg
Gs, Gs, Gg, Gg, Gg, Gs, Gs, Gs, Gs, Gs, Gs, Gs, Gs, Gg, Gg, Gg, Gg, Gg, Rd, Rd, Gg, Rr, Rr, Gs, Gs, Gg, Gg, Gg, Gs, Gg, Gg, Gg, Ss, Gg, Ww, Ww
Gg, Gg, Gg, Gg, Gg, Gg, Gs, Gg, Gs, Gg, Gs, Gs, Gg, Gg, Gg, Gs, Gg, Gg, Ch, Gg, Gg, Gg, Gg^Vh, Rr, Rr, Gs, Gs, Gg, Gg, Gs, Gg, Ss, Ww, Ww, Ch, Ch
Gg, Gg, Gg, Gg, Gg, Gg, Gg, Gg, Gs, Gs, Gs, Gg, Hh, Hh, Gg, Gg^Vh, Gg, Ch, Rd, Ch, Gs, Gg, Rd, Rd, Gg, Rr, Rr, Gg, Gg, Gg, Ss, Ss, Ch, Ch, Ds, Ds
Gg, Gg, Gs, Gg, Gg, Gg, Gg, Gs, Gg, Gg, Gg, Gs, Gs, Gg, Gg, Gg, Gg, 2 Kh, Ch, Rd, Rd, Gg, Rd, Gg, Gg, Gg, Gg, Rr, Ww^Bw\, Ww, Ww, Ch, Kh, Ds, Gs, Gg
Gs, Gs, Gg, Gg, Gs, Gg, Gg, Gg, Gg, Gg, Gg, Gg, Gg, Gg, Gg, Gg, Gg, Gg, Gg, Gg, Gg, Rd, Ce, Ce, Ce, Gs, Gs, Gg, Ww, Ww^Bw\, Ww^Bw\, Gs, Gg, Gs, Rr, Rr
Gs, Gs, Gg, Gg, Gg, Gg, Gg, Gg, Gs, Gs, Gg, Gg, Gg, Gg, Gg, Gs, Gs, Gg, Gg, Gg, Ce, Ce, Re, Ds, Ds, Ce, Ce, Gs, Ww, Ww, Gg, Rr, Rr, Rr, Gg, Gg
Gs, Gs, Gs, Gg, Gg, Gg, Hh, Gg, Gg, Gs, Gg, Hh, Gg, Gg, Gg, Gs, Gg, Gg, Ce, Ce, Ds, Ds, Re, Gs, Gs, Ds, Ds, Ce, Ss, Ch, Kh, Gg, Rr, Rr, Rr, Rd
Gs, Gs, Gs, Gg, Gg, Gg, Gg, Gg, Gg, Gg, Gg, Hh, Hh, Hh, Gg, Gg, Ce, Ce, Ds, Ds, Gs, Gs, Re, Re, Ww, Gs, Gs, Ds, Ww, Ch, Ds, Gs, Rr, Gg, Rd, Gg
Gs, Gs, Gg, Gg, Hh, Hh, Hh, Gg, Gg, Gg, Hh, Hh, Hh, Hh, Gg, Gs, Ce, Ds, Gs, Gs, Re, Re, Re, Gs, Re, Gs^Vht, Gs, Ss, Ss, Ch, Ds, Gs, Rr, Gs, Gg^Vh, Gg
Gs, Gs, Gs, Gg, Gg, Gg, Gg, Gg, Gg, Gg, Hh, Hh, Hh, Gg, Gg, Gs, Ce, Ds, Gs, Gs^Vht, Ww, Gs, Ce, Gs^Vht, Re, Gs, Gs, Ss, Ss, Ch, Ds, Gs, Rr, Gs, Gg, Gg
Gs, Gs, Gs, Gg, Gs, Gg, Gs, Gg, Gs, Gs, Gg, Hh, Gg, Gg, Gg, Gs, Ce, Ds, Gs, Gs, Gs, Gs^Vht, Ce, 1 Ke, Gs, Ww, Gs, Ww, Ww, Wot, Ds, Gs, Rr, Gg, Gg, Gg
Gs, Gs, Hh, Gg, Gg, Gg, Gs, Gg, Gs, Gg, Gg, Gg, Gs, Gg, Gs, Gs, Ce, Ds, Gs, Ww, Re, Re, Gs^Vht, Ce, Re, Re, Gs, Ss, Ww, Ch, Ds, Gs, Rr, Rd, Gg, Gg
Hh, Hh, Hh, Gg, Gg, Gg, Gg, Gs, Gs, Gg, Gg, Gg, Gs, Gs, Gs, Gg, Ce, Ds, Ds, Re, Gs, Gs, Gs, Ww, Re, Gs, Gs, Ss, Ss, Ch, Ds, Gs, Rr, Gg^Vh, Gg, Gg
Hh, Hh, Gg, Gg, Gs, Gg, Gg, Gg, Gs, Gg, Gg, Gg, Gs, Gs, Gs, Gs, Ds, Ce, Ce, Ds, Ds, Ds, Gs, Gs^Vht, Re, Ww, Gs, Ss, Ss, Ch, Ds, Gs, Gs, Rd, Rd, Rd
Gg, Gg, Gs, Gs, Gg, Gg, Gg, Gg, Hh, Gg, Gg, Gg, Gs, Gs, Ds, Ds, Ds, Ds, Ds, Ce, Ce, Ds, Ds, Re, Gs, Gs, Gs, Ww, Ss, Ch, Ds, Gg, Gs, Gs, Gg, Gg
Gg, Gs, Gg, Gg, Gg, Gg, Hh, Hh, Gg, Hh, Gg, Gg, Gs, Gs, Ds, Ds, Ds, Ds, Ds, Ww, Ds, Ce, Ce, Ww, Ds, Gs, Ss, Ss, Ss, Ch, Ch, Gg, Gg, Gg, Ww, Ww
Gs, Gs, Gg, Gg, Hh, Gg, Hh, Hh, Gg, Gg, Gg, Ww, Ww, Ww, Ww, Ds, Ds, Ds, Ds, Ds, Ds, Ds, Ds, Ce, Ds, Ds, Wwf, Ww, Ww, Kh, Ww, Ww, Ww, Ww, Ww, Ww
Gs, Gg, Gg, Gg, Gg, Hh, Hh, Gg, Gg, Ww, Ww, Ww, Wo, Wo, Wo, Ww, Ww, Ww, Ww, Ww, Ww, Ds, Ww, Ww, Ww, Wwf, Ww, Ww, Wo, Ww, Ww, Ww, Wo, Wo, Wo, Wo
Gg, Gg, Gg, Gg, Gg, Hh, Hh, Gg, Ww, Ww, Ww, Ww, Wo, Wo, Wo, Wo, Wo, Wo, Wo, Ww, Wo, Ww, Wo, Ww, Ww, Wwf, Wo, Wo, Wo, Wo, Wo, Wo, Wo, Wo, Wo, Wo
