border_size=1
usage=map

Dd          , Dd          , Dd          , Dd          , Dd          , Dd          , Dd          , Dd          , Dd          , Dd          , Dd          , Dd          , Dd          , Dd          , Dd          , Dd          , Gs          , Gs          , Gg          , Gg          , Gg          , Gg          , Gg          , Gg          , Gg          , Gg          , Hh          , Gg          , Hh          , Gg          , Gs^Fds      , Gs^Fds      , Gs^Fds      , Gg          , Gs^Fds      , Gg          , Gs^Fds      , Gs^Fds      
Dd          , Dd          , Dd          , Dd          , Dd          , Dd          , Dd          , Dd          , Dd          , Dd          , Hd          , Dd          , Hd          , Hd          , Dd          , Hh          , Gs          , Gg          , Gg          , Gg          , Ce          , Ce          , Ce          , Gg          , Gg          , Gg          , Gg          , Gg          , Hh          , Gg          , Gs^Fds      , Gg          , Gg          , Gg          , Gs^Fds      , Gg          , Gs^Fds      , Gg          
Dd          , Dd          , Dd          , Dd          , Dd          , Dd          , Dd          , Dd          , Hd          , Hd          , Gs          , Dd          , Dd          , Gs          , Gs          , Gg          , Gg          , Gg          , Ce          , Ce          , Ds          , Ds          , Ds          , Ce          , Ce          , Gg          , Gg          , Gg          , Gg          , Gg          , Gs^Fds      , Gs^Fds      , Gg          , Gs^Fds      , Gg          , Gg          , Gs^Fds      , Gs^Fds      
Dd          , Hd          , Dd          , Dd          , Dd          , Dd          , Gs          , Gs          , Dd          , Gs          , Dd          , Hh          , Gs          , Gs          , Dd          , Gs          , Gg          , Ce          , Ds          , Ds          , Rr          , Rr          , Rr          , Ds          , Ds          , Ce          , Gg          , Gg          , Gg          , Gg          , Gg          , Gs^Fds      , Gg          , Hh          , Hh          , Gs^Fds      , Gg          , Gg          
Dd          , Hd          , Dd          , Dd          , Dd          , Dd          , Dd          , Dd          , Gs          , Gs          , Dd          , Gs          , Hh          , Gs          , Gs          , Gg          , Gg          , Ce          , Ds          , Rr          , Gs^Vht      , Gs          , Gs^Vht      , Rr          , Ds          , Ce          , Gg          , Gg          , Gg          , Gs^Fds      , Gg          , Gg          , Gg^Vh       , Hh          , Gs^Fds      , Gg          , Gs^Fds      , Gs^Fds      
Dd          , Dd          , Dd          , Dd          , Dd          , Dd          , Dd          , Hd          , Dd          , Dd          , Dd          , Gs          , Dd          , Gg          , Gg          , Gg          , Gg          , Ce          , Rr          , Rr          , Rr          , Gs          , Rr          , Rr          , Rr          , Ce          , Gg          , Gg          , Gg          , Gg          , Gg          , Gg          , Gg          , Gg          , Gs^Fds      , Gg          , Gg          , Gs^Fds      
Dd          , Dd          , Dd          , Dd          , Dd          , Dd          , Dd          , Gs          , Gs          , Dd          , Gg          , Dd          , Gg          , Gg          , Gg          , Gg          , Rr          , Rr          , Ce          , Ds          , Ds          , Rr          , Ds          , Ds          , Ce          , Rr          , Rr          , Gg          , Gg          , Gg          , Gs^Fds      , Gg          , Gs^Fds      , Gs^Fds      , Gg          , Gs^Fds      , Gg          , Gs^Fds      
Dd          , Dd          , Dd          , Dd          , Dd          , Dd          , Hd          , Hh          , Dd          , Dd          , Dd          , Gs          , Gs          , Gg          , Gg          , Rr          , Gg          , Gg          , Gg          , Ce          , Ce          , Ds          , Ce          , Ce          , Gg          , Gg          , Rr          , Gg          , Gg          , Gg          , Gg          , Gg          , Gs^Fds      , Gs^Fds      , Hh          , Gg          , Gs^Fds      , Gg          
Dd          , Dd          , Dd          , Dd          , Dd          , Dd          , Hd          , Gg          , Dd          , Gs          , Dd          , Gs          , Gg          , Gg          , Gg          , Rr          , Gg          , Gg          , Gg          , Gg          , Gg          , Ce          , Gg          , Gg          , Gg          , Gg          , Rr          , Gg          , Gg          , Gg          , Gs^Fds      , Gg          , Gg          , Gg          , Gs^Fds      , Gg          , Gs^Fds      , Gg          
Dd          , Dd          , Dd          , Dd          , Dd          , Dd          , Dd          , Gs          , Dd          , Dd          , Gs          , Dd          , Gg          , Gg^Vh       , Gg          , Rr          , Gg          , Gg          , Gg          , Gg          , Gg          , Gg          , Gg          , Gg          , Gg          , Gg          , Rr          , Gg          , Gg          , Gg          , Gg          , Gg          , Gs^Fds      , Gg          , Gg          , Gs^Fds      , Gg          , Gg          
Dd          , Dd          , Dd          , Dd          , Dd          , Dd          , Dd          , Gs          , Dd          , Gs          , Gs          , Dd          , Gs          , Gg          , Gg          , Rr          , Gg          , Gg^Vh       , Gg          , Gg          , Ch          , Ch          , Ch          , Gg          , Gg          , Gg^Vh       , Rr          , Gg          , Gg          , Gg          , Gs^Fds      , Gg          , Gs^Fds      , Gg          , Hh          , Gg          , Gs^Fds      , Gs^Fds      
Dd          , Dd          , Dd          , Dd          , Dd          , Dd          , Dd          , Dd          , Dd          , Dd          , Hh          , Gs          , Dd          , Gg          , Gs          , Rr          , Gg          , Gg          , Ch          , Gg          , 2 Kh        , Gg^Vh       , Ch          , Gg          , Gg          , Gg          , Rr          , Gg          , Gg          , Gs^Fds      , Gs^Fds      , Gs^Fds      , Gs^Fds      , Gg          , Hh          , Hh          , Gg          , Gs^Fds      
Dd          , Dd          , Dd          , Dd^Do       , Dd          , Dd          , Dd          , Hd          , Hd          , Hh          , Hh          , Gg          , Dd          , Gs          , Gs          , Rr          , Gg          , Gg          , Ch          , Gg^Vh       , Ch          , Gg          , Gg          , Gg          , Gg          , Gg          , Rr          , Gg^Vh       , Gg          , Gs^Fds      , Gs^Fds      , Gs^Fds      , Gs^Fds      , Gs^Fds      , Gs^Fds      , Gg          , Gs^Fds      , Gs^Fds      
Dd          , Dd          , Dd          , Dd          , Dd          , Dd          , Dd          , Dd          , Dd          , Hd          , Dd          , Dd          , Dd          , Dd          , Gg          , Rr          , Rr          , Gg          , Gg          , Ch          , Gg          , Gg          , Gg          , Gg          , Gg          , Gg          , Rr          , Gg          , Gg          , Gg          , Gg^Vh       , Gs^Fds      , Gs^Fds      , Gs^Fds      , Gg          , Gs^Fds      , Gs^Fds      , Gs^Fds      
Dd          , Dd          , Dd          , Dd          , Dd          , Dd          , Dd          , Dd          , Dd          , Dd          , Hh          , Dd          , Gg          , Dd          , Gs          , Gg          , Gg          , Rr          , Rr          , Gg          , Gg          , Gg^Vh       , Gg          , Gg          , Rr          , Rr          , Gg          , Rr          , Rr          , Gs^Fds      , Gg          , Gs^Fds      , Gg          , Gg          , Gg          , Gg          , Gg          , Gg          
Dd          , Dd          , Dd          , Dd          , Dd          , Dd          , Dd          , Dd          , Hd          , Hh          , Ch          , Gs          , Gs          , Gs          , Gg          , Gg          , Gg          , Gg          , Gg          , Rr          , Rr          , Gg          , Rr          , Rr          , Gg          , Gg          , Gg          , Gg          , Gg          , Rr          , Rr          , Gg          , Gg          , Gg          , Gg          , Gg          , Gg          , Gg          
Dd          , Dd          , Hd          , Md          , Hd          , Dd          , Dd          , Dd          , Hd          , Hh          , Hh          , Gs          , Gs          , Dd          , Gg          , Gg          , Gg          , Gg^Vh       , Re^Gvs      , Gg          , Gg          , Rr          , Gg          , Gg          , Gg          , Gg          , Gg          , Gg          , Re^Gvs      , Gg          , Gg          , Rr          , Rr          , Gg          , Gg          , Gg          , Gg          , Gg          
Dd          , Hd          , Md          , Md          , Hd          , Dd          , Dd^Vda      , Dd          , Dd          , Hd          , Hh          , Gs          , Dd          , Dd          , Gg          , Gg          , Gg          , Re^Gvs      , Re^Gvs      , Re^Gvs      , Gg          , Rr          , Gg          , Gg          , Gg          , Gg          , Re^Gvs      , Re^Gvs      , Re^Gvs      , Re^Gvs      , Re^Gvs      , Gg          , Gg^Vh       , Rr          , Rr          , Gg^Wm       , Gg          , Gg          
Dd          , Hd          , Md          , Hd          , Dd          , Dd          , Dd          , Dd          , Dd          , Dd          , Gs          , Gg          , Gs          , Gg          , Gg          , Gg          , Gg          , Re^Gvs      , Re^Gvs      , Re^Gvs      , Gg          , Rr          , Gg          , Gg          , Re^Gvs      , Gg          , Gg          , Re^Gvs      , Re^Gvs      , Re^Gvs      , Gg          , Gg          , Gg          , Gg          , Gg          , Rr          , Rr          , Gg          
Dd          , Dd          , Dd          , Dd          , Dd          , Dd          , Dd          , Dd          , Hd          , Dd          , Gs          , Gs          , Dd          , Gs          , Gs          , Gg          , Gg          , Gg          , Gg          , Re^Gvs      , Gg          , Rr          , Gg^Wm       , Re^Gvs      , Re^Gvs      , Re^Gvs      , Re^Gvs      , Gg          , Gg          , Gg          , Gg          , Gg          , Re^Gvs      , Re^Gvs      , Re^Gvs      , Gg          , Gg          , Rr          
Dd          , Dd          , Dd          , Dd          , Dd          , Dd          , Dd          , Hd          , Hh          , Hh          , Dd          , Dd          , Dd          , Gs          , Gg          , Gg          , Gg          , Gg          , Gg          , Gg          , Gg          , Rr          , Gg          , Re^Gvs      , Re^Gvs      , Re^Gvs      , Gg          , Gg          , Gg          , Gg          , Re^Gvs      , Re^Gvs      , Re^Gvs      , Re^Gvs      , Re^Gvs      , Re^Gvs      , Re^Gvs      , Gg          
Dd          , Dd          , Dd          , Dd          , Dd          , Dd          , Dd          , Hd          , Hh          , Ch          , Dd          , Dd          , Gs          , Dd          , Gg          , Gg          , Gg          , Re^Gvs      , Re^Gvs      , Gg          , Gg          , Rr          , Gg          , Re^Gvs      , Gg          , Gg          , Gg          , Gg          , Re^Gvs      , Gg          , Gg          , Re^Gvs      , Re^Gvs      , Re^Gvs      , Re^Gvs      , Re^Gvs      , Gg          , Gg          
Dd          , Dd          , Dd          , Dd          , Dd          , Dd          , Dd          , Hd          , Hd          , Hh          , Hh          , Dd          , Dd          , Gs          , Gg          , Gg          , Re^Gvs      , Re^Gvs      , Re^Gvs      , Re^Gvs      , Gg          , Rr          , Gg          , Gg          , Gg          , Gg          , Re^Gvs      , Re^Gvs      , Re^Gvs      , Re^Gvs      , Gg^Vh       , Gg          , Gg          , Re^Gvs      , Gg          , Gg          , Gg          , Gg          
Dd          , Dd          , Dd          , Dd          , Dd          , Dd          , Dd          , Md          , Hd          , Hd          , Hh          , Gg          , Gg          , Gs          , Gg          , Gg          , Gg          , Re^Gvs      , Re^Gvs      , Re^Gvs      , Gg          , Rr          , Gg          , Gg          , Gg          , Re^Gvs      , Re^Gvs      , Re^Gvs      , Re^Gvs      , Re^Gvs      , Re^Gvs      , Re^Gvs      , Gg          , Gg          , Gg          , Gg          , Gg          , Gg          
Dd          , Dd          , Dd^Do       , Dd          , Dd          , Dd          , Dd          , Dd          , Hd          , Hh          , Gg          , Gg          , Dd          , Gg          , Gg          , Gg          , Gg          , Re^Gvs      , Gg          , Gg          , Gg          , Rr          , Gg          , Re^Gvs      , Re^Gvs      , Gg          , Gg          , Re^Gvs      , Re^Gvs      , Re^Gvs      , Gg          , Gg          , Gg          , Gg          , Re^Gvs      , Gg          , Gg          , Gg          
Dd          , Dd          , Dd          , Dd          , Dd          , Dd          , Dd          , Dd          , Dd          , Gg          , Dd          , Gg          , Gg          , Gg          , Gg          , Gg          , Gg          , Gg          , Gg          , Gg          , Gg          , Rr          , Gg          , Re^Gvs      , Re^Gvs      , Re^Gvs      , Re^Gvs      , Gg          , Gg          , Ce          , 1 Ke        , Ce          , Re^Gvs      , Re^Gvs      , Re^Gvs      , Re^Gvs      , Re^Gvs      , Gg          
Dd          , Dd          , Dd          , Dd          , Hd          , Dd          , Hh          , Dd          , Dd          , Gg          , Gg          , Gg          , Gg          , Gg          , Gg          , Gg          , Gg          , Gg          , Re^Gvs      , Gg          , Gg          , Rr          , Gg          , Re^Gvs      , Re^Gvs      , Re^Gvs      , Gg          , Gg          , Ce          , Ce          , Ce          , Re^Gvs      , Re^Gvs      , Re^Gvs      , Re^Gvs      , Re^Gvs      , Re^Gvs      , Re^Gvs      
Dd          , Dd          , Md          , Md          , Hd          , Dd          , Gs          , Hh          , Dd          , Gs          , Gs          , Gg          , Gg          , Gg          , Gg          , Gg          , Re^Gvs      , Re^Gvs      , Re^Gvs      , Re^Gvs      , Gg          , Rr          , Gg          , Re^Gvs      , Gg          , Gg          , Gg          , Gg          , Re^Gvs      , Re^Gvs      , Re^Gvs      , Gg          , Gg          , Re^Gvs      , Re^Gvs      , Re^Gvs      , Gg          , Gg          
Dd          , Dd          , Md          , Hd          , Dd          , Hd          , Gs          , Dd          , Gg          , Gg          , Gg          , Gg          , Gg          , Gg          , Gg          , Re^Gvs      , Re^Gvs      , Re^Gvs      , Re^Gvs      , Re^Gvs      , Gg          , Rr          , Gg^Wm       , Gg          , Gg          , Gg          , Re^Gvs      , Re^Gvs      , Re^Gvs      , Re^Gvs      , Re^Gvs      , Gg^Vh       , Re^Gvs      , Gg          , Gg          , Gg          , Gg          , Gg          
Dd          , Dd          , Hd          , Dd          , Hh          , Hh          , Hh          , Gg          , Gg          , Dd          , Gg          , Gg          , Re^Gvs      , Re^Gvs      , Re^Gvs      , Gg          , Gg          , Re^Gvs      , Re^Gvs      , Re^Gvs      , Gg          , Rr          , Gg          , Gg          , Re^Gvs      , Gg          , Gg          , Re^Gvs      , Re^Gvs      , Re^Gvs      , Re^Gvs      , Re^Gvs      , Gg          , Gg          , Gg          , Gg          , Gg          , Re^Gvs      
Dd          , Hh          , Dd          , Hh          , Gg          , Gg          , Gg          , Gs          , Gg          , Gg          , Re^Gvs      , Re^Gvs      , Re^Gvs      , Re^Gvs      , Re^Gvs      , Re^Gvs      , Re^Gvs      , Gg          , Gg          , Gg          , Gg          , Rr          , Gg          , Re^Gvs      , Re^Gvs      , Re^Gvs      , Re^Gvs      , Gg          , Gg          , Re^Gvs      , Gg          , Gg          , Gg          , Gg          , Re^Gvs      , Re^Gvs      , Re^Gvs      , Gg          
Dd          , Dd          , Hd          , Dd          , Gg          , Gs          , Gs          , Gs          , Re^Gvs      , Gg          , Gg          , Re^Gvs      , Re^Gvs      , Re^Gvs      , Re^Gvs      , Re^Gvs      , Gg          , Gg          , Gg          , Gg          , Gg          , Rr          , Gg          , Re^Gvs      , Re^Gvs      , Re^Gvs      , Re^Gvs      , Re^Gvs      , Gg          , Gg          , Gg          , Gg          , Re^Gvs      , Re^Gvs      , Re^Gvs      , Re^Gvs      , Re^Gvs      , Re^Gvs      
Dd          , Dd^Do       , Gs          , Gg          , Gs          , Gs          , Gg          , Re^Gvs      , Re^Gvs      , Re^Gvs      , Re^Gvs      , Gg          , Gg          , Re^Gvs      , Gg          , Gg          , Gg          , Gg          , Re^Gvs      , Re^Gvs      , Gg          , Rr          , Gg          , Re^Gvs      , Re^Gvs      , Re^Gvs      , Gg          , Gg          , Gg          , Gg          , Re^Gvs      , Gg          , Gg          , Re^Gvs      , Re^Gvs      , Re^Gvs      , Re^Gvs      , Re^Gvs      
Dd          , Hh          , Dd          , Gg          , Gs          , Hd          , Gg          , Re^Gvs      , Re^Gvs      , Re^Gvs      , Re^Gvs      , Re^Gvs      , Gg          , Gg          , Gg          , Gg          , Re^Gvs      , Re^Gvs      , Re^Gvs      , Re^Gvs      , Gg          , Rr          , Gg          , Gg          , Gg          , Gg          , Gg          , Gg          , Re^Gvs      , Re^Gvs      , Re^Gvs      , Re^Gvs      , Re^Gvs      , Gg          , Gg          , Re^Gvs      , Gg          , Gg          
Dd          , Dd          , Gs          , Dd          , Gg          , Gg          , Gs          , Gg          , Re^Gvs      , Re^Gvs      , Gg          , Gg          , Gg          , Gg          , Gg          , Re^Gvs      , Re^Gvs      , Re^Gvs      , Gg^Vh       , Re^Gvs      , Gg          , Rr          , Gg          , Gg          , Gg          , Gg          , Gg          , Re^Gvs      , Re^Gvs      , Re^Gvs      , Re^Gvs      , Re^Gvs      , Re^Gvs      , Re^Gvs      , Gg          , Gg          , Gg          , Gg          
Dd          , Dd          , Gs          , Gg          , Gg          , Gs          , Gg          , Gg          , Gg          , Gg          , Gg          , Gg          , Re^Gvs      , Re^Gvs      , Re^Gvs      , Gg          , Gg          , Re^Gvs      , Re^Gvs      , Re^Gvs      , Gg          , Rr          , Gg^Wm       , Gg          , Re^Gvs      , Re^Gvs      , Re^Gvs      , Gg          , Gg          , Re^Gvs      , Re^Gvs      , Re^Gvs      , Gg          , Gg          , Gg          , Gg          , Re^Gvs      , Gg          
Dd          , Dd          , Gg          , Hd          , Gg          , Gg          , Gg          , Gg          , Gg          , Gg          , Gg          , Re^Gvs      , Re^Gvs      , Re^Gvs      , Re^Gvs      , Re^Gvs      , Re^Gvs      , Gg          , Gg          , Gg          , Gg          , Rr          , Gg          , Re^Gvs      , Re^Gvs      , Re^Gvs      , Re^Gvs      , Re^Gvs      , Re^Gvs      , Gg          , Gg          , Gg          , Gg          , Gg          , Re^Gvs      , Re^Gvs      , Re^Gvs      , Re^Gvs      
Dd          , Dd          , Gg          , Gg          , Hh          , Gg          , Gg          , Gg          , Gg          , Gg          , Gg          , Re^Gvs      , Re^Gvs      , Re^Gvs      , Re^Gvs      , Re^Gvs      , Gg          , Gg          , Gg          , Gg          , Gg          , Rr          , Gg          , Re^Gvs      , Re^Gvs      , Re^Gvs      , Re^Gvs      , Re^Gvs      , Gg          , Gg          , Gg          , Gg          , Gg          , Re^Gvs      , Re^Gvs      , Re^Gvs      , Re^Gvs      , Re^Gvs      
