border_size=1
usage=map

Hh          , Re          , Re          , Hh          , Hh          , Mm          , Mm          , Hh          , Hh          , Hh          , Hh          , Re          , Gg          , Hh          , Mm          , Mm          , Hh          , Hh          , Gg          , Gg          , Re          , Re          , Hh          , Mm          , Mm          , Mm          , Mm          , Mm          , Mm          , Mm          , Mm          , Mm          
Hh          , Gg          , Re          , Gg          , Hh          , Hh          , Hh          , Hh          , Gg          , Hh          , Re          , Re          , Gg          , Hh          , Mm          , Hh          , Gg          , Gg          , Gg          , Re          , Gg          , Gg          , Gg          , Hh          , Hh          , Mm          , Mm          , Mm          , Mm          , Mm          , Mm          , Mm          
Mm          , Hh          , Re          , Gg          , Gg          , Gg          , Gg          , Gg          , Gg          , Gg          , Re          , Gg          , Gg          , Hh          , Hh          , Hh          , Gg          , Gg          , Re          , Re          , Hh          , Hh          , Gg          , Gg          , Hh          , Mm          , Mm^Xm       , Mm^Xm       , Mm^Xm       , Mm          , Hh          , Hh          
Hh          , Hh          , Re          , Gg          , Ce          , Ce          , Ds          , Ce          , Gg          , Gg^Vc       , Re          , Gg          , Hh          , Hh          , Hh          , Gg          , Hh          , Re          , Gg          , Gg          , Hh          , Gg          , Hh          , Hh          , Mm^Xm       , Mm^Xm       , Mm^Xm       , Mm^Xm       , Mm^Xm       , Hh          , Hh          , Hh          
Hh          , Gg          , Re          , Gg          , Ds          , Ds          , Re          , Ds          , Ds          , Gg          , Re          , Gg          , Hh          , Mm          , Hh          , Hh^Vhh      , Gg          , Re          , Hh          , Gg          , Gg          , Hh          , Hh          , Hh          , Hh          , Mm^Xm       , Hh          , Mm^Xm       , Mm^Xm       , Mm^Xm       , Hh          , Hh          
Hh          , Gg          , Re          , Gg          , Ce          , Ds          , Ds          , Ds          , Ce          , Gg          , Re          , Gg          , Hh          , Hh          , Hh          , Gg          , Gg          , Re          , Gg          , Gg          , Hh          , Hh          , Mm          , Mm          , Mm          , Hh          , 3 Mm        , Hh          , Hh          , Hh          , Hh          , Hh          
Hh          , Hh          , Re          , Gg          , Gg          , Gg          , Gg          , Ce          , Gg          , Gg          , Re          , Gg          , Gg          , Mm          , Mm          , Hh          , Gg          , Re          , Gg          , Gg          , Gg          , Hh          , Hh          , Mm          , Mm          , Mm          , Mm          , Mm          , Mm          , Hh          , Hh          , Hh          
Mm          , Hh          , Hh          , Re          , Re          , Gg          , Gg          , Gg          , Gg          , Ce          , Re          , Ce          , Gg          , Hh          , Hh          , Hh          , Re          , Re          , Gg          , Gg          , Hh          , Hh          , Hh          , Hh          , Hh          , Mm          , Mm^Xm       , Mm^Xm       , Mm^Xm       , Mm          , Hh          , Hh          
Hh          , Mm          , Mm          , Hh          , Hh          , Re          , Re          , Ce          , Ds          , Ds          , Re          , Ds          , Ds          , Ce          , Re          , Re          , Gg          , Gg          , Hh          , Gg          , Gg          , Hh          , Mm          , Mm          , Mm          , Hh          , Mm^Xm       , Mm^Xm       , Hh          , Hh          , Mm^Xm       , Hh          
Gg          , Hh          , Mm          , Mm          , Hh          , Gg          , Ce          , Re          , Re          , Re          , Gg^Vc       , Re          , Re          , Re          , Ce          , Gg          , Hh          , Hh          , Mm          , Hh          , Hh          , Hh          , Hh          , Mm          , Mm          , Hh          , Hh          , Mm^Xm       , Hh          , Mm^Xm       , Mm          , Hh          
Re          , Hh          , Hh          , Mm          , Hh          , Gg          , Gg          , Ds          , Re          , Ds          , Ds          , Ds          , Re          , Ds          , Gg          , Gg          , Hh          , Mm          , Mm          , Hh          , Hh          , Hh          , Hh          , Hh          , Hh          , Mm          , Mm          , Hh          , Mm          , Hh          , Hh          , Hh          
Gg          , Re          , Re          , Hh          , Gg          , Gg          , Ce          , Ds          , Re          , Gg^Vc       , Ds          , Gg^Vc       , Re          , Ds          , Ce          , Gg          , Hh          , Hh          , Mm^Vhh      , Mm          , Hh          , Gg          , Gg          , Hh          , Hh          , Mm          , Mm          , Mm          , Mm          , Mm          , Hh          , Hh          
Gg          , Gg          , Gg          , Re          , Re          , Gg          , Re          , Re          , Ds          , Re          , Re          , Re          , Ds          , Re          , Re          , Gg          , Gg          , Hh          , Hh          , Hh          , Hh          , Gg          , Hh          , Gg          , Hh          , Hh^Vhh      , Hh          , Mm          , Mm          , Mm          , Hh          , Hh          
Hh          , Gg          , Hh          , Gg          , Gg          , Re          , Gg          , Ce          , Gg          , Ds          , Re          , Ds          , Gg          , Ce          , Gg          , Re          , Re          , Gg          , Gg          , Hh          , Gg          , Gg          , Hh          , Gg          , Gg          , Hh          , Hh          , Hh          , Hh          , Hh          , Hh          , Hh          
Hh          , Hh          , Mm          , Hh          , Hh          , Gg          , Gg          , Gg          , Gg          , Ce          , Re          , Ce          , Gg          , Gg          , Hh          , Gg          , Gg          , Re          , Re          , Gg          , Gg          , Hh          , Gg          , Hh          , Hh          , Hh          , Mm          , Mm          , Mm          , Mm          , Mm          , Hh          
Hh          , Mm          , Mm          , Mm          , Hh          , Hh          , Gg          , Gg          , Re          , Re          , Gg          , Gg          , Hh          , Gg          , Gg          , Gg          , Gg          , Gg          , Gg          , Re          , Re          , Gg          , Gg          , Gg          , Hh          , Hh          , Mm          , Mm          , Mm          , Mm          , Gg          , Hh          
Hh          , Hh          , Mm          , Mm          , Hh          , Hh          , Re          , Re          , Gg          , Gg          , Gg          , Gg          , Hh          , Hh          , Hh          , Hh          , Hh          , Gg          , Gg          , Gg          , Gg^Vh       , Re          , Gg          , Hh          , Hh          , Mm          , Mm          , Mm          , Mm          , Mm          , Hh          , Hh          
Hh          , Hh          , Hh          , Hh          , Re          , Re          , Gg          , Gg          , Hh          , Gg          , Hh          , Hh          , Mm^Vhh      , Mm          , Hh          , Hh          , Hh          , Hh          , Hh          , Hh          , Gg          , Re          , Re          , Gg          , Gg          , Hh          , Hh          , Mm          , Mm          , Mm          , Hh          , Hh          
Hh          , Hh          , Gg          , Gg          , Re          , Gg          , Hh          , Hh          , Hh          , Hh          , Hh          , Hh          , Hh          , Mm          , Mm          , Mm          , Mm          , Hh          , Hh          , Hh          , Hh          , Gg          , Gg          , Re          , Re          , Gg          , Hh          , Mm          , Hh          , Hh          , Hh^Vhh      , Hh          
Hh          , Hh          , Hh          , Gg          , Re          , Gg          , Gg          , Gg          , Hh          , Hh          , Hh          , Hh          , Hh          , Mm          , Hh          , Mm          , Hh          , Hh          , Hh          , Hh          , Mm          , Hh          , Hh          , Gg          , Re          , Gg          , Gg          , Hh          , Hh          , Hh          , Hh          , Hh          
Mm          , Hh          , Mm          , Hh          , Hh          , Re          , Gg          , Hh          , Mm^Xm       , Mm          , Mm          , Hh          , Hh          , Hh          , Hh          , Hh          , Mm          , Mm^Xm       , Mm          , Mm          , Hh          , Mm          , Hh          , Gg          , Gg          , Re          , Re          , Gg          , Ce          , Ce          , Ce          , Hh          
Mm          , Mm          , Mm          , Mm          , Hh          , 2 Kud       , Cud         , Hh          , Mm          , Mm^Xm       , Mm^Xm       , Mm^Xm       , Mm^Xm       , Hh          , Mm          , Mm          , Mm^Xm       , Mm          , Mm          , Mm          , Mm          , Mm          , Mm          , Hh          , Hh          , Gg          , Gg          , Re          , Re          , Ke          , Ce          , Hh          
Mm          , Mm          , Mm          , Mm          , Hh          , Cud         , Gg          , Cud         , Hh          , Hh          , Hh          , Mm          , Mm          , Hh          , Mm          , Mm          , Mm          , Mm          , Mm          , Hh          , Mm          , Mm          , Mm          , Hh          , Hh          , Gg          , Gg          , Ce          , 1 Ke        , Re          , Re          , Gg          
Hh          , Mm          , Hh          , Mm          , Hh          , Cud         , Re          , Re          , Gg          , Hh          , Hh          , Mm          , Hh          , Hh          , Mm          , Hh          , Hh          , Hh          , Mm          , Mm^Xm       , Hh          , Hh          , Mm          , Hh          , Hh^Vhh      , Gg          , Gg          , Ce          , Ce          , Ce          , Gg          , Re          
Hh          , Hh          , Hh^Vhh      , Hh          , Hh          , Gg          , Re          , Rr          , Rr          , Cud         , Re          , Hh          , Hh^Vhh      , Hh          , Hh          , Hh          , Hh          , Hh          , Mm          , Mm          , Hh          , Mm          , Hh          , Hh          , Hh          , Hh          , Hh          , Hh          , Hh          , Hh          , Hh          , Gg          
Hh          , Hh          , Hh          , Hh          , Hh          , Gg          , Hh          , Cud         , Gg          , Re          , Rr          , Re          , Gg          , Hh          , Gg          , Hh          , Hh          , Mm          , Mm          , Mm          , Hh          , Hh          , Mm          , Mm          , Mm          , Hh          , Hh          , Hh          , Mm          , Mm^Vhh      , Mm          , Hh          
Hh          , Hh          , Mm          , Hh          , Hh          , Hh          , Hh          , Hh          , Hh          , Gg          , Gg          , Rr          , Rr          , Gg          , Gg          , Hh          , Hh          , Hh          , Hh          , Hh          , Hh          , Hh          , Mm          , Mm          , Mm          , Hh          , Hh          , Mm          , Mm          , Mm          , Mm          , Hh          
Hh          , Mm          , Mm          , Mm          , Hh          , Hh          , Hh          , Hh          , Hh          , Gg          , Hh          , Re          , Gg          , Rr          , Rr          , Gg          , Gg          , Gg          , Gg          , Gg          , Gg          , Hh          , Mm          , Mm          , Mm          , Mm          , Hh          , Hh          , Mm          , Mm          , Hh          , Hh          
Hh          , Hh          , Mm          , Mm          , Mm          , Mm          , Mm          , Hh          , Hh          , Gg          , Gg          , Hh          , Gg          , Gg          , Gg          , Rr          , Rr          , Gg          , Gg^Vh       , Gg          , Gg          , Hh          , Hh          , Mm          , Hh          , Hh          , Hh          , Mm          , Mm          , Mm          , Hh          , Hh          
Hh          , Hh          , Hh          , Hh          , Hh          , Mm          , Mm          , Mm          , Mm          , Hh          , Hh          , Gg          , Hh          , Gg          , Gg          , Gg          , Gg          , Rr          , Rr          , Gg          , Gg          , Hh          , Hh          , Hh          , Hh          , Hh          , Hh          , Hh          , Hh          , Hh          , Hh          , Hh          
Hh          , Hh          , Hh          , Hh          , Hh          , Mm          , Mm          , Mm          , Hh          , Hh          , Hh          , Hh          , Mm          , Hh          , Hh          , Hh          , Gg          , Gg          , Gg          , Rr          , Rr          , Gg          , Gg          , Hh          , Gg          , Hh          , Hh          , Hh          , Hh          , Hh          , Hh          , Hh          
Hh          , Hh          , Hh          , Hh          , Hh          , Hh          , Hh          , Hh          , Hh          , Hh          , Hh          , Mm          , Mm          , Mm          , Hh          , Hh          , Hh          , Gg          , Hh          , Gg          , Gg          , Rr          , Rr          , Gg          , Gg          , Gg          , Gg          , Hh          , Hh          , Hh          , Hh          , Hh          
