border_size=1
usage=map

Mm          , Mm          , Mm          , Mm          , Mm          , Mm          , Mm          , Mm          , Mm          , Mm          , Mm          , Mm          , Mm          , Mm          , Mm          , Mm          , Hh          , Hh          , Mm          , Mm          , Mm          , Mm          , Mm          , Mm          , Mm          , Mm          , Wo          , Wo          , Wo          , Wo          , Gg          , Hh          , Hh          
Mm          , Mm          , Mm          , Mm          , Mm          , Mm          , Mm          , Mm          , Mm          , Mm          , Mm          , Mm          , Mm          , Mm          , Mm          , Mm          , Hh          , Hh          , Mm          , Mm          , Mm          , Mm          , Mm          , Mm          , Mm          , Mm          , Wo          , Wo          , Wo          , Wo          , Gg          , Hh          , Hh          
Mm          , Mm          , Mm          , Mm          , Mm          , Mm          , Mm          , Mm          , Mm          , Hh          , Hh          , Mm          , Mm          , Mm          , Hh          , Hh          , Wo          , Gg          , Hh          , Mm          , Mm          , Mm          , Mm          , Mm          , Gg          , Gg          , Wo          , Wo          , Gg          , Gg          , Hh          , Hh          , Hh          
Mm          , Mm          , Mm          , Mm          , Mm          , Mm          , Mm          , Mm          , Mm          , Hh          , Hh          , Mm          , Gg          , Hh          , Wo          , Wo          , Gg          , Wo          , Wo          , Hh          , Gg          , Hh          , Hh          , Mm          , Wo          , Wo          , Wo          , Gg          , Hh          , Hh          , Mm          , Mm          , Mm          
Mm          , Mm          , Mm          , Mm          , Mm          , Mm          , Hh          , Mm          , Gg          , Gg          , Gg          , Gg          , Wo          , Wo          , Gg          , Gg          , Dd^Vdt      , Gg          , Gg          , Wo          , Wo          , Gg          , Gg          , Gg          , Wo          , Wo          , Gg          , Gg          , Hh          , Mm          , Mm          , Mm          , Mm          
Mm          , Mm          , Mm          , Mm          , Mm          , Mm          , Hh          , Hh          , Gg          , Gg          , Wo          , Wo          , Gg          , Gg          , Ds          , Ds          , Ds          , Ds          , Ds          , Gg          , Ce          , Wo          , Wo          , Wo          , Wo          , Gg          , Gg          , Hh          , Hh          , Mm          , Mm          , Mm          , Mm          
Mm          , Mm          , Hh          , Mm          , Hh          , Hh          , Gg          , Gg          , Wo          , Wo          , Gg          , Gg          , Ds          , Ds          , Dd^Dr       , Ds          , Ds          , Ds          , Ds          , Ds          , Ce          , Ce          , Ww          , Ww          , Wo          , Gg          , Gg          , Hh          , Gg          , Hh          , Hh          , Mm          , Mm          
Hh          , Hh          , Gg          , Hh          , Gg          , Gg          , Wo          , Wo          , Gg          , Gg          , Gs^Ft       , Gs^Ft       , Ds          , Ds          , Ds          , Ds          , Ds          , Ds          , Gs^Ft       , Gs^Ft       , Ds          , Ke          , Ww^Bw\      , Ww          , Ce          , Wo          , Wo          , Gg          , Gg          , Hh          , Hh          , Hh          , Hh          
Hh          , Hh          , Gg          , Gg          , Wo          , Wo          , Gg          , Gg          , Ds          , Ds          , Ds          , Ds          , Ds          , Ds          , Ds          , Ds          , Ds          , Ds          , Ds          , Gs^Ft       , Ds          , Ww          , Ww          , Ke          , Ce          , Ce          , Gg          , Wo          , Wo          , Gg          , Gg          , Hh          , Hh          
Gg          , Gg          , Wo          , Wo          , Gg          , Gg          , Ds          , Ds          , Dd^Do       , Ds          , Ds          , Ds          , Hd          , Hd          , Ds          , Ds          , Ds          , Dd^Do       , Ds          , Ds          , Ww          , Ww          , Ds          , Ds          , Gs^Ft       , Gs^Ft       , Ds          , Gg          , Gg          , Wo          , Wo          , Gg          , Gg          
Hh          , Hh          , Wo          , Gg          , Rd          , Ds          , Ds          , Ds          , Ds          , Ds          , Ds          , Hd          , Ds          , Hd          , Ds          , Dd^Dr       , Ds          , Ds          , Ds          , Ds          , Ww^Bw\      , Ww          , Ds          , Ds          , Ds          , Ds          , Ds          , Ds          , Dd^Vdt      , Gg          , Wo          , Gg          , Gg          
Gg          , Gg          , Wo          , Gg          , Ds          , Rd          , Rd          , Ds          , Ds          , Ds          , Ds          , Ds          , Ds          , Hd          , Ds          , Ds          , Ds          , Ds          , Ds          , Ww          , Ww          , Ds          , Ds          , Ds          , Ds          , Ds          , Ds          , Ds          , Ds          , Gg          , Wo          , Gg          , Gg          
Gg          , Gg          , Wo          , Gg          , Ds          , Ds          , Ds          , Rd          , Rd          , Ds          , Ds          , Gs^Ft       , Gs^Ft       , Ds          , Ds          , Dd^Do       , Ds          , Ds          , Ww          , Ww          , Ds          , Ds          , Ds          , Dd^Do       , Ds          , Ds          , Ds          , Ds          , Ds          , Gg          , Wo          , Hh          , Hh          
Hh          , Hh          , Wo          , Gg          , Ds          , Ds          , Ds          , Ds          , Ds          , Rd          , Rd          , Ds          , Gs^Ft       , Gs^Ft       , Ds          , Ds          , Ds          , Ds          , Ww^Bw\      , Ww          , Ds          , Ds          , Dd^Dr       , Ds          , Ds          , Gs^Ft       , Ds          , Ds          , Ds          , Gg          , Wo          , Hh          , Hh          
Mm          , Mm          , Wo          , Gg          , Ds          , Dd^Do       , Ds          , Dd^Dr       , Ds          , Ds          , Ds          , Rd          , Rd          , Ds          , Ds          , Ds          , Ds          , Ww          , Ww          , Ds          , Ds          , Ds          , Ds          , Ds          , Gs^Ft       , Gs^Ft       , Dd^Dr       , Ds          , Ds          , Gg          , Wo          , Gg          , Gg          
Mm          , Mm          , Wo          , Gg          , Ds          , Ds          , Ds          , Ds          , Ds          , Ds          , Hd          , Ds          , Ds          , Rd          , Rd          , Ds          , Ww          , Ww          , Ds          , Ds          , Ds          , Dd^Do       , Ds          , Ds          , Gs^Ft       , Ds          , Ds          , Ds          , Ds          , Gg          , Wo          , Gg          , Gg          
Mm          , Mm          , Wo          , Gg          , Ds          , Ds          , Ds          , Ds          , Hd          , Hd          , Ds          , Ds          , Ds          , Ds          , Ds          , Ww^Bw\      , Ww^Bw\      , Ww          , Ds          , Ds          , Ds          , Ds          , Dd^Dr       , Ds          , Ds          , Hd          , Hd          , Ds          , Gs^Ft       , Gg          , Wo          , Gg          , Gg          
Hh          , Hh          , Wo          , Gg          , Gs^Ft       , Ds          , Gs^Ft       , Hd          , Hd          , Ds          , Ds          , Ds          , Ds          , Ds          , Ds          , Ww          , Ww          , Ww^Bw\      , Rd          , Ds          , Gs^Ft       , Ds          , Ds          , Ds          , Ds          , Ds          , Hd          , Ds          , Ds          , Gg          , Wo          , Hh          , Hh          
Gg          , Gg          , Wo          , Gg          , Gs^Ft       , Gs^Ft       , Hd          , Hd          , Ds          , Ds          , Ds          , Dd^Do       , Ds          , Ds          , Ww          , Ww          , Ds          , Ds          , Ds          , Rd          , Rd          , Ds          , Ds          , Ds          , Ds          , Hd          , Ds          , Ds          , Ds          , Gg          , Wo          , Hh          , Hh          
Hh          , Hh          , Wo          , Gg          , Ds          , Gs^Ft       , Ds          , Ds          , Gs^Ft       , Gs^Ft       , Ds          , Ds          , Ds          , Ds          , Ww^Bw\      , Ww          , Ds          , 1 Ds        , Ds          , Gs^Ft       , Gs^Ft       , Rd          , Rd          , Ds          , Ds          , Ds          , Ds          , Dd^Do       , Ds          , Gg          , Wo          , Gg          , Gg          
Mm          , Mm          , Wo          , Gg          , Ds          , Gs^Ft       , Ds          , Ds          , Ds          , Ds          , Ds          , Ds          , Ds          , Ww          , Ww          , Ds          , Ds          , Ds          , Ds          , Gs^Ft       , Ds          , Ds          , Ds          , Rd          , Rd          , Ds          , Ds          , Ds          , Ds          , Gg          , Wo          , Gg          , Gg          
Hh          , Hh          , Wo          , Gg          , Ds          , Ds          , Ds          , Ds          , Ds          , Dd^Do       , Ds          , Ds          , Ww          , Ww          , Ds          , Ds          , Ds          , Dd^Do       , Ds          , Ds          , Ds          , Ds          , Ds          , Ds          , Ds          , Rd          , Rd          , Ds          , Ds          , Gg          , Wo          , Gg          , Gg          
Hh          , Hh          , Wo          , Gg          , Dd^Vdt      , Ds          , Ds          , Ds          , Ds          , Ds          , Ds          , Ds          , Ww^Bw\      , Ww          , Ds          , Ds          , Ds          , Ds          , Ds          , Ds          , Hd          , Ds          , Ds          , Ds          , Ds          , Ds          , Ds          , Rd          , Rd          , Gg          , Wo          , Gg          , Gg          
Hh          , Hh          , Wo          , Gg          , Gg          , Ds          , Ds          , Ds          , Ds          , Ds          , Ds          , Ww          , Ww          , Ds          , Ds          , Ds          , Ds          , Ds          , Ds          , Hd          , Hd          , Ds          , Ds          , Ds          , Dd^Do       , Ds          , Ds          , Ds          , Gg          , Gg          , Wo^Bw\      , Gg          , Gg          
Hh          , Hh          , Mm          , Wo          , Wo          , Gg          , Gg          , Ds          , Ce          , Ds          , Ww          , Ww          , Ds          , Ds          , Ds          , Dd^Do       , Ds          , Ds          , Ds          , Ds          , Ds          , Dd          , Gs^Ft       , Ds          , Ds          , Ds          , Gg          , Gg          , Wo          , Wo          , Gg          , Gg          , Gg          
Mm          , Mm          , Hh          , Hh          , Hh          , Wo          , Wo          , Ce          , Ce          , Ke          , Ww^Bw\      , Ww          , Ds          , Ds          , Ds          , Ds          , Ds          , Ds          , Gs^Ft       , Gs^Ft       , Gs^Ft       , Gs^Ft       , Ds          , Ds          , Gg          , Gg          , Wo          , Wo          , Gg          , Gg          , Gg          , Hh          , Hh          
Mm          , Mm          , Hh          , Hh          , Mm          , Gg          , Gg          , Wo          , Wo          , Ww          , Ww          , Ke          , Ce          , Ds          , Ds          , Ds          , Ds          , Ds          , Ds          , Gs^Ft       , Ds          , Ds          , Gg          , Gg          , Wo          , Wo          , Gg          , Gg          , Hh          , Gg          , Hh          , Hh          , Hh          
Mm          , Mm          , Mm          , Hh          , Mm          , Hh          , Mm          , Gg          , Wo          , Ww          , Wo          , Ce          , Ce          , Ds          , Ds          , Ds          , Ds          , Ds          , Ds          , Ds          , Gg          , Gg          , Wo          , Wo          , Gg          , Gg          , Hh          , Hh          , Hh          , Gg          , Hh          , Mm          , Mm          
Mm          , Mm          , Mm          , Mm          , Hh          , Mm          , Hh          , Wo          , Wo          , Wo          , Gg          , Wo          , Wo          , Gg          , Gg          , Ds          , Dd^Vdt      , Ds          , Gg          , Gg          , Wo          , Wo          , Gg          , Gg          , Gg          , Hh          , Hh          , Mm          , Mm          , Hh          , Hh          , Mm          , Mm          
Mm          , Mm          , Mm          , Mm          , Hh          , Mm          , Hh          , Wo          , Wo          , Gg          , Gg          , Gg          , Gg          , Wo          , Wo          , Gg          , Gg          , Gg          , Wo          , Wo          , Gg          , Gg          , Hh          , Gg          , Hh          , Hh          , Mm          , Mm          , Mm          , Mm          , Mm          , Mm          , Mm          
Mm          , Mm          , Mm          , Mm          , Hh          , Hh          , Wo          , Wo          , Gg          , Gg          , Hh          , Hh          , Hh          , Gg          , Gg          , Wo          , Wo          , Wo          , Gg          , Gg          , Hh          , Hh          , Mm          , Hh          , Hh          , Hh          , Hh          , Mm          , Mm          , Mm          , Mm          , Mm          , Mm          
Mm          , Mm          , Mm          , Hh          , Gg          , Wo          , Gg          , Gg          , Hh          , Hh          , Mm          , Hh          , Mm          , Hh          , Gg          , Gg          , Hh          , Gg          , Hh          , Hh          , Hh          , Mm          , Hh          , Hh          , Hh          , Hh          , Mm          , Mm          , Mm          , Mm          , Mm          , Mm          , Mm          
Mm          , Mm          , Mm          , Mm          , Mm          , Wo          , Mm          , Gg          , Mm          , Hh          , Mm          , Mm          , Mm          , Mm          , Mm          , Mm          , Mm          , Mm          , Mm          , Mm          , Mm          , Mm          , Mm          , Mm          , Mm          , Mm          , Mm          , Mm          , Mm          , Mm          , Mm          , Mm          , Mm          
Mm          , Mm          , Mm          , Mm          , Mm          , Wo          , Mm          , Gg          , Mm          , Hh          , Mm          , Mm          , Mm          , Mm          , Mm          , Mm          , Mm          , Mm          , Mm          , Mm          , Mm          , Mm          , Mm          , Mm          , Mm          , Mm          , Mm          , Mm          , Mm          , Mm          , Mm          , Mm          , Mm          
