border_size=1
usage=map

Xos         , Xos         , Xos         , Xos         , Xol         , Xol         , Rrc         , Cud         , Cud         , Cud         , Rrc         , Xol         , Xol         , Xos         , Xos         , Xos         , Xos         
Xos         , Xos         , Xol         , Xos         , Rrc         , Rrc         , Rrc         , Cud         , 2 Kud       , Cud         , Rrc         , Rrc         , Rrc         , Xos         , Xol         , Xos         , Xos         
Xos         , Xol         , Rrc         , Rrc         , Rrc         , Rrc         , Rrc         , Rrc         , Rrc         , Rrc         , Rrc         , Rrc         , Rrc         , Rrc         , Rrc         , Xol         , Xos         
Xol         , Rrc         , Rrc         , Rrc         , Rrc         , Rrc         , Rrc         , Rrc         , Rrc         , Rrc         , Rrc         , Rrc         , Rrc         , Rrc         , Rrc         , Rrc         , Xos         
Xos         , Rrc         , Rrc         , Rrc         , Rrc         , Rrc         , Rrc         , Rrc         , Rrc         , Rrc         , Rrc         , Rrc         , Rrc         , Rrc         , Rrc         , Rrc         , Xos         
Xol         , Rrc         , Rrc         , Rrc         , Rrc         , Rrc         , Rrc         , Rrc         , Rrc         , Rrc         , Rrc         , Rrc         , Rrc         , Rrc         , Rrc         , Rrc         , Xos         
Xol         , Rrc         , Rrc         , Rrc         , Rrc         , Rrc         , Rrc         , Rrc         , Rrc         , Rrc         , Rrc         , Rrc         , Rrc         , Rrc         , Rrc         , Rrc         , Xos         
Xol         , Rrc         , Rrc         , Rrc         , Rrc         , Rrc         , Rrc         , Rrc         , Rrc         , Rrc         , Rrc         , Rrc         , Rrc         , Rrc         , Rrc         , Rrc         , Xos         
Xos         , Rrc         , Rrc         , Rrc         , Rrc         , Rrc         , Rrc         , Rrc         , Rrc         , Rrc         , Rrc         , Rrc         , Rrc         , Rrc         , Rrc         , Rrc         , Xos         
Xol         , Xos         , Xos         , Rrc         , Rrc         , Rrc         , Rrc         , Rrc         , Rrc         , Rrc         , Rrc         , Rrc         , Rrc         , Rrc         , Xos         , Xos         , Xol         
Rrc         , Xol         , Xol         , Xos         , Xos         , Rrc         , Xos         , Rrc         , Rrc         , Rrc         , Xos         , Rrc         , Xos         , Xos         , Xol         , Xol         , Rrc         
Rrc         , Rrc         , Rrc         , Xol         , Xol         , Xos         , Xos         , Rrc         , Rrc         , Rrc         , Xos         , Xos         , Xol         , Xol         , Rrc         , Rrc         , Rrc         
Rrc         , Rrc         , Rrc         , Rrc         , Rrc         , Xol         , Xol         , Rrc         , Rrc         , Rrc         , Xos         , Xol         , Rrc         , Rrc         , Rrc         , Rrc         , Rrc         
Rp          , Rrc         , Rrc         , Rrc         , Rrc         , Rrc         , Xol         , Rrc         , Rrc         , Rrc         , Xol         , Rrc         , Rrc         , Rrc         , Rrc         , Rrc         , Rp          
Gg          , Rp          , Rp          , Rrc         , Rrc         , Rrc         , Rrc         , Xos         , Rrc         , Xos         , Rrc         , Rrc         , Rrc         , Rrc         , Rp          , Rp          , Gg          
Gg          , Gg^Fet      , Gg          , Rp          , Rp          , Rrc         , Rrc         , Rrc         , Rrc         , Rrc         , Rrc         , Rrc         , Rp          , Rp          , Gg          , Gg^Fet      , Gg          
Gg          , Gg          , Gg          , Gg^Fet      , Gg          , Rp          , Rp          , Rrc         , 1 Rrc       , Rrc         , Rp          , Rp          , Gg          , Gg^Fet      , Gg          , Gg          , Gg          
Gg          , Gg          , Gg          , Gg          , Gg          , Gg^Fet      , Rp          , Rrc         , Rrc         , Rrc         , Rp          , Gg^Fet      , Gg          , Gg          , Gg          , Gg          , Gg          
Gg          , Gg          , Gg          , Gg          , Gg          , Gg          , Rp          , Rrc         , Rrc         , Rrc         , Rp          , Gg          , Gg          , Gg          , Gg          , Gg          , Gg          
Gg          , Gg          , Gg          , Gg          , Gg          , Gg^Fet      , Rp          , Rrc         , Rrc         , Rrc         , Rp          , Gg^Fet      , Gg          , Gg          , Gg          , Gg          , Gg          
Gg          , Gg          , Gg          , Gg          , Gg          , Gg          , Rp          , Rrc         , Rrc         , Rrc         , Rp          , Gg          , Gg          , Gg          , Gg          , Gg          , Gg          
Gg          , Gg          , Gg          , Gg          , Gg          , Gg^Fet      , Rp          , Rrc         , Rrc         , Rrc         , Rp          , Gg^Fet      , Gg          , Gg          , Gg          , Gg          , Gg          
