Gg, Gg, Gs^Fmw, Gg, Gg, Gs^Fp, Gg, Gs^Fp, Gg, Gg, Gs^Fp, Gs^Fp, Gg, Gg, Re, Gg, Ww, Ww, Gg, Gg, Rr, Rr
Gg, Gg, Aa^Fma, Gg, Gg, Aa^Fma, Gg, Aa^Fda, Gg, Gg, Gs^Fmw, Gs^Fmw, Gg, Re, Gg, Gg, Ww, Ww, Gg, Gg, Rr, Rr
Gg, Gg, Gg, Aa^Fma, Aa^Fda, Gg, Gg, Gg, Gg, Aa^Fma, Aa^Fda, Gg, Gg, Gg, Gg, Gg, Ww, Gg, Gg, Rr, Gg, Gg
Gs^Fp, Aa^Fda, Gg, Gg, Gg, Gs^Fmw, Gg, Gg, Gs^Fmw, Gg, Gg, Gg, Re, Gg, Gg, Ww, Ww, Gg, Gg, Rr, Gg, Gg
Gs^Fp, Aa^Fma, Aa^Fda, Gs^Fmw, Gs^Fmw, Aa^Fma, Gg, Gg, Gg, Gs^Fp, Gg, Gg, Gg, Gg, Ww, Ww, Gg, Gg, Gg, Rr, Gg, Gg
Gs^Fp, Aa^Fma, Gg, Gg, Gg, Gg, Gg, Gs^Fp, Gg, Gg, Re, Re, Gg, Ww, Ww, Gg, Gg, Gg, Rr, Rr, Gg, Gg
Gs^Fp, Aa^Fda, Gs^Fmw, Gs^Fp, Gg, Gs^Fp, Gg, Gg, Gg, Gg, Gg, Gg, Ww, Ww, Gg, Gg, Gg, Gg, Rr, Gg, Gg, Gg
Gg, Gg, Gs^Fmw, Gg, 2 Gll, Gg, Gg, Aa^Fma, Gg, Re, Gg, Ww, Ww, Gg, Gg, Gg, Rr, Rr, Gg, Gg, Gg, Gg
Gs^Fp, Aa^Fda, Aa^Fda, Gg, Gg, Gg, Gs^Fp, Gs^Fp, Gg, Gg, Gg, Ww, Ww, Gg, Gg, Gg, Rr, Gg, Hh, Hh, Gg, Gg
Gs^Fp, Aa^Fma, Gg, Gs^Fmw, Gg, Gg, Gg, Gs^Fp, Gg, Re, Gg, Ww, Gg, Gg, Gg, Gg, Rr, Gg, Gg, Hh, Gg, Gg
Gs^Fp, Aa^Fma, Gg, Gs^Fp, Gg, Gs^Fmw, Aa^Fma, Gg, Gg, Re, Gg, Ww, Ww, Gg, Gg, Gg, Rr, Gg, Gg, Hh, Gg, Gg
Gs^Fp, Gs^Fmw, Aa^Fda, Gg, Aa^Fda, Gg, Gs^Fmw, Gg, Gs^Fp, Gs^Fmw, Re, Gg, Ww, Gg, Gg, Gg, Rr, Gg, Gg, Gg, Gg, Gg
Gg, Gg, Gg, Gg, Gs^Fmw, Gg, Gg, Gg, Gg, Re, Gg, Gg, Ww, Gg, Gg, Gg, Gg, Rr, Rr, Gg, Gg, Gg
Gg, Gg, Aa^Fma, Gg, Gs^Fp, Gg, Gg, Gg, Gg, Re, Gg, Ww, Ww, Gg, Gg, Hh, Hh, Gg, Rr, Gg, Gg, Gg
Gg, Gg, Gg, Gg, Gs^Fp, Gg, Gg, Gs^Fp, Re, Gg, Ww, Ww, Gg, Gg, Gg, Gg, Gg, Gg, Rr, Gg, Gg, Gg
Gs^Fp, Aa^Fma, Gs^Fp, Gg, Gg, Gg, Gg, Gg, Re, Gg, Ww, Ww, Ww, Gg, Gg, Gg, Rr, Rr, Gg, Gg, Gg, Gg
Gg, Gg, Gs^Fmw, Gg, Gg, Gs^Fmw, Gg, Gs^Fp, Gg, Gg, Gg, Ww, Ww, Ww, Ww, Gg, Rr, Gg, Gg, Gg, Gg, Gg
Gg, Gg, Gg, Gg, Gs^Fp, Gs^Fmw, Re, Re, Gg, Gg, Re, Gg, Gg, Ww, Ww, Chr, Chr, Gg, Gg, Gg, Gg, Gg
Gg, Re, Re, Gs^Fp, Gg, Re, Gg, Gg, Gg, Gs^Fp, Gg, Re, Chr, Chr, Ww^Bw/, Rr, Chr, Hh, Gg, Gg, Gg, Gg
Gs^Fp, Gs^Fp, Gg, Re, Gs^Fp, Gg, Gs^Fp, Gg, Gg, Gg, Gg, Gg, Kh, Rr, Ww, Ww, Hh, Hh, Gg, Gg, Gg, Gg
Re, Re, Gg, Gs^Fmw, Gg, Gg, Gg, Gs^Fmw, Gs^Fmw, Gg, Rr, Rr, Gg, Ww, Ww, Ww, Hh, Hh, Gg, Gg, Gg, Gg
Gg, Gg, Gs^Fmw, Gs^Fmw, Gs^Fp, Gg, Gg, Gg, Gg, Gs^Fp, Rr, Gg, Gg, Re, Ww, Ww, Hh, Gg, Gg, Hh, Gg, Gg
Gg, Gg, Gs^Fmw, Gs^Fmw, Gg, Gs^Fp, Gg, Gg, Gg, Gg, Rr, Gg, Gg, Gg, Re, Ww, Ww, Gg, Hh, Hh, Gg, Gg
Gg, Gg, Gg, Gg, Gg, Gs^Fmw, Gg, Gg, Rr, Rr, Gg, Gg, Hh, Gg, Hh, Ww, Ww, Re, Hh, Hh, Hh, Hh
Gs^Fp, Gs^Fmw, Gg, Gg, Gs^Fmw, Gg, Gg, Hh, Rr, Gg, Gg, Hh, Mm, Mm, Mm, Hh, Ww, Ww, Ww, Re, Hh, Hh
Gg, Gg, Gg, Gg, Hh, Gg, Gg, Hh, Rr, Gg, Hh, Hh, Mm, Mm, Hh, Gg, Ww, Ww, Hh, Ww, Ww, Ww
Gg, Gg, Gg, Hh, Gg, Gg, Gg, Hh, Hh, Rr, Hh, Hh, Mm, Mm, Hh, Hh, Ww, Gg, Gg, Hh, Hh, Hh
Gg, Gg, Gg, Hh, Gg, Gg, Gg, Gg, Hh, Rr, Gg, Hh, Hh, Hh, Ww, Ww, Ww, Hh, Hh, Hh, Mm, Mm
Gg, Gg, Hh, Hh, Hh, Gg, Gg, Hh, Hh, Rr, Gg, Gg, Hh, Hh, Ww, Ww, Hh, Hh, Mm, Mm, Mm, Mm
Gg, Gg, Hh, Hh, Hh, Hh, Gg, Gg, Rr, Rr, Hh, Hh, Hh, Hh, Hh, Ww, Hh, Hh, Mm, Mm, Mm, Mm
Hh, Hh, Mm, Mm, Mm, Hh, Hh, Gg, Rr, Gg, Hh, Hh, Mm, Mm, Hh, Ww, Ww, Hh, Mm, Mm, Mm, Mm
Hh, Hh, Mm, Mm, Mm, Mm, Hh, Gg, Rr, Gg, Hh, Mm, Mm, Mm, Mm, Hh, Hh, Hh, Mm, Mm, Mm, Mm
Hh, Hh, Hh, Mm, Hh, Hh, Gg, Gg, Rr, Hh, Mm, Mm, Mm, Mm, Mm, Hh, Hh, Hh, Hh, Mm, Mm, Mm
Mm, Mm, Mm, Hh, Hh, Gg, Rr, Rr, Hh, Hh, Mm, Mm, Mm, Mm, Hh, Hh, Hh, Hh, Mm, Mm, Mm, Mm
Mm, Mm, Mm, Mm, Hh, Gg, Rr, Gg, Hh, Mm, Mm, Mm, Hh, Hh, Wo, Ww, Hh, Mm, Mm, Mm, Mm, Mm
Mm, Mm, Mm, Mm, Hh, Gg, Gg, Rr, Gg, Hh, Mm, Mm, Hh, Hh, Wo, Hh, Hh, Mm, Mm, Mm, Mm, Mm
Mm, Mm, Mm, Mm, Hh, Hh, Gg, Rr, Rr, Hh, Mm, Mm, Hh, Ww, Wo, Wo, Hh, Mm, Mm, Mm, Mm, Mm
Mm, Mm, Mm, Hh, Hh, Gg, Gg, Gg, Gg, Rr, Hh, Hh, Hh, Hh, Hh, Ww, Hh, Mm, Mm, Mm, Mm, Mm
Mm, Mm, Mm, Hh, Hh, Hh, Gg, 1 Gg, Rr, Rr, Hh, Hh, Mm, Mm, Mm, Hh, Mm, Mm, Mm, Mm, Mm, Mm
Mm, Mm, Mm, Mm, Mm, Hh, Hh, Gg, Rr, Hh, Mm, Mm, Mm, Mm, Mm, Mm, Mm, Mm, Mm, Mm, Mm, Mm
Mm, Mm, Mm, Mm, Mm, Hh, Gg, Gg, Rr, Hh, Mm, Mm, Mm, Mm, Mm, Mm, Mm, Mm, Mm, Mm, Mm, Mm
Mm, Mm, Mm, Mm, Mm, Hh, Gg, Gg, Rr, Hh, Mm, Mm, Mm, Mm, Mm, Mm, Mm, Mm, Mm, Mm, Mm, Mm
