Aa, Aa, Aa^Fpa, Gg, Gs^Fp, Gs^Fmw, Aa^Fpa, Gs^Fmw, Gs^Fdw, Aa, Gg, Aa, Gg, Aa, Aa, Gg, Aa^Fma, Gs^Fmw, Aa^Fpa, Gg, Gs^Fmw, Aa, Gg, Aa, Gs^Fp, Aa^Fpa, Aa, Aa
Aa, Aa, Aa^Fpa, Gg, Aa^Fma, Mm, Gs^Fmw, Gs^Fp, Gs^Fdw, Aa, Gg, Aa, Gg, Aa, Aa, Gg, Aa^Fma, Aa^Fma, Gs^Fmw, Gg, Aa^Fpa, Aa, Gg, Aa, Aa^Fma, Gs^Fp, Aa, Aa
Aa^Fpa, Gs^Fdw, Gs^Fdw, Gs^Fdw, Aa, Gs^Fdw, Gs^Fmw, Aa^Fma, Gs^Fdw, Gs^Fdw, Aa^Fpa, Aa^Fpa, Gg, Aa^Vca, Gg, Aa^Fpa, Gg, Aa^Fpa, Gs^Fdw, Aa^Fpa, Gg, Aa^Fma, Gg, Aa^Fma, Gs^Fdw, Aa^Fma, Aa, Aa
Aa^Fpa, Gs^Fdw, Aa^Fpa, Gs^Fmw, Aa, Gs^Fdw, Gg, Aa^Fpa, Aa^Fma, Gg, Aa^Fpa, Gs^Fdw, Aa^Fpa, Gg, Gg, Gs^Fp, Aa^Vca, Aa^Fpa, Gs^Fp, Gs^Fp, Gg, Gs^Fdw, Gs^Fp, Gs^Fdw, Aa^Fpa, Gg, Gg, Gg
Gg, Gg, Aa^Vca, Aa, Aa, Gs^Fp, Ha, Aa^Vca, Aa^Fpa, Gs^Fdw, Gg, Gs^Fdw, Gs^Fmw, Gs^Fmw, Aa^Fma, Aa, Aa, Aa^Fma, Aa^Fma, Gg, Aa^Fma, Aa^Fma, Ha, Aa^Vca, Gg, Aa^Fpa, Aa^Fpa, Aa^Fma
Aa^Fpa, Aa^Fpa, Aa^Fpa, Gg, Gg, Gs^Fdw, Ha, Ha, Aa^Fma, Gs^Fmw, Gg, Ha, Ha, Ha, Gg, Aa^Fma, Gs^Fdw, Aa^Fpa, Gg, Gg, Aa^Fma, Gs^Fmw, Ha, Gg, Aa^Fpa, Gg, Gs^Fmw, Aa^Fma
Aa^Fpa, Gs^Fmw, Aa^Fpa, Aa^Fma, Ce, Gg, Ce, Ce, Ce, Ce, Aa, Ha, Aa^Fpa, Ha, Gg, Gs^Fp, Gg, Aa^Fpa, Gg, Aa^Fpa, Gg, Aa^Fma, Ha, Ha, Aa^Fma, Aa^Fpa, Aa^Fma, Aa^Fpa
Aa^Fpa, Aa^Fpa, Gg, Gg, Ai, Ce, Ce, 4 Ke, Gg, Aa, Aa^Fma, Aa^Fpa, Gs^Vc, Ha, Gs^Fdw, Gs^Fdw, Aa^Fpa, Aa^Fma, Gg, Aa^Fpa, Aa^Fpa, Ha, Ha, Ha, Gg, Aa^Fpa, Gs^Fmw, Gs^Fp
Aa^Fpa, Gs^Fdw, Gg, Ai, Ww, Ds, Ds, Ce, Ce, Aa^Fpa, Gg, Gs^Fdw, Gg, Aa^Fpa, Aa^Fpa, Aa^Fpa, Aa^Fpa, Aa^Fma, Gs^Fp, Gs^Vh, Gg, Aa^Fma, Aa^Fma, Aa, Gs^Fp, Aa^Fpa, Aa^Fpa, Aa^Fma
Gg, Gg, Gs^Vc, Gg, Ai, Wwf, Wwf, Ds, Ce, Gg, Aa^Fpa, Gs^Fmw, Gg, Gg, Gs^Fp, Gs^Fdw, Gg, Gs^Fdw, Gg, Ha, Ha, Gg, Gg, Aa, Gs^Fmw, Gg, Aa^Fpa, Gs^Fdw
Gg, Gg, Gg, Gg, Gg, Ww, Wwf, Ai, Gg, Gg, Gs^Vc, Aa^Fpa, Gs^Fdw, Gs^Fmw, Aa^Fma, Gs^Fdw, Ha, Aa^Fma, Gs^Fp, Gs^Vh, Aa, Ha, Gg, Aa^Vca, Gs^Fmw, Aa^Fma, Gg, Gg
Aa^Fpa, Aa^Fpa, Gs^Fdw, Gg, Gg, Gg, Ww, Ai, Gg, Gg, Gs^Fp, Aa^Fma, Aa, Gg, Aa^Vca, Gs^Fp, Ha, Ha, Gs^Fp, Aa^Fma, Gg, Aa^Fpa, Gg, Aa^Fpa, Gg, Aa^Fpa, Aa^Fpa, Gs^Fmw
Gg, Gg, Aa^Fpa, Gs^Fmw, Gg, Gg, Wwf, Ai, Gg, Gg, Gg, Aa^Fpa, Aa^Fpa, Gg, Aa^Fma, Gg, Aa^Fpa, Gs^Fp, Gs^Fdw, Aa^Fpa, Gs^Fdw, Gg, Gs^Fdw, Gs^Fdw, Aa^Fma, Gs^Fmw, Gs^Fp, Aa^Fma
Aa^Fpa, Gs^Fdw, Ha, Ha, Gg, Gg, Gg, Ww, Ds, Gg, Gs^Fdw, Aa^Fpa, Aa^Fpa, Aa^Fpa, Aa^Fpa, Gg, Gs^Fp, Aa^Fpa, Aa^Fma, Aa^Fma, Aa, Aa^Fpa, Aa^Fma, Gg, Ha, Gg, Aa^Fma, Aa^Fpa
Ds, Ds, Ww, Wwf, Wwf, Gg, Ds, Ww, Ww, Gg, Aa^Fpa, Gg, Gg, Gg, Aa^Fpa, Gs^Fdw, Gg, Gg, Aa^Fpa, Gg, Aa, Aa, Gg, Ha, Ha, Ha, Aa^Fpa, Gs^Fp
Ww, Ww, Wo, Ww, Ww, Wwf, Ww, Ww, Wwf, Ds, Gg, Aa^Fpa, Aa^Fpa, Aa^Fma, Gg, Gs^Fdw, Gg, Aa^Fpa, Gs^Fmw, Gs^Fp, Aa^Fma, Gg, Gg, Aa^Vca, Ds, Gs^Fmw, Ai, Ai
Wo, Wo, Ww, Ww, Wwf, Ww, Wo, Ww, Ww, Gg, Aa^Vea, Gg, Ds, Gg, Gg, Gg, Ds, Gg, Gg, Aa^Fma, Ds, Gg, Wwf, Wwf, Wwf, Ai, Ai, Ai
Ww, Ww, Aa^Fpa, Gs^Fdw, Gg, Wwf, Ww, Wo, Ww, Wwf, Wwf, Ds, Ww, Ds, Ce, Ce, Gg, Ds, Ce, Ds, Gg, Gg, Wwf, Ww, Ww, Ai, Wo, Wo
Ds, Ds, Gs^Fmw, Gg, Gs^Vc, Gs^Fdw, Gg, Ww, Ww, Wwf, Ww, Ww, Ww, Ww, Ww, Aa^Vha, Gs, Aa^Vha, Ww, Wwf, Ww, Wwf, Ww, Ww, Gg, Ww, Wo, Wo
Gg, Gg, Aa^Fpa, Ha, Ha, Aa^Fpa, Aa^Fma, Gg, Gg, Ai, Ai, Wo, Wo, Ww, Ww^Bw/, Ww^Bw/, Ww, Ww, Wo, Ww, Wo, Ww, Ww, Ds, Ww, Ww, Ww, Ww
Gg, Gg, Aa^Fpa, Ha, Gs^Fdw, Gs^Fdw, Gg, Gg, Aa^Fpa, Gg, Ai, Ww, Gg, Ch, Gs^Vh, Wo, Ww, Ww, Ww, Wo, Wo, Wo, Ww, Wo, Ww, Ww, Wwf, Wwf
Gs^Fdw, Gs^Fdw, Gg, Gg, Gg, Gg, Wwf, Aa^Vca, Wwf, Gg, Wo, Wo, Ds, Ch, Wo, Ds, Ww, Ww, Wwf, Ww, Ds, Wo, Ds, Ww, Wwf, Wwf, Wwf, Wwf
Aa^Fma, Aa^Fpa, Gg, Gg, Wwf, Wwf, Wwf, Wwf, Ww, Ww, Ww, Ww, Ww, Ww^Bsb|, Ww, Wo, Ww, Wwf, Rr, Rr, Rr, Ds, Ww, Ww, Gg, Gg, Gg, Gg
Ds, Ds, Gg, Gg, Ww, Ww, Ww, Ww, Wwf, Ww, Wwf, Wwf, Wwf, Ww^Bsb|, Ds, Ww, Ds, Ds, Rr, Gg, Gs, Rr, Ce, Gg, Re^Gvs, Re^Gvs, Re^Gvs, Re^Gvs
Gg, Gg, Gg, Wwf, Wwf, Ww, Wwf, Wwf, Gg, Ce, Rr, Rr, Rr, Rr, Rr, Gg, Gg, Rr^Vhc, Rr, Gg, Rr^Vhc, Rr, Ce, Gg, Re^Gvs, Re^Gvs, Re^Gvs, Re^Gvs
Gg, Gg, Ds, Wwf, Ww, Ww, Gg, Gg, Ce, Ce, Rr, Rr^Vhc, Gg, Gg, Rr, Kh, Kh, Rr, Gg, Rr, Rr, Rr, Ce, Gg, Re^Gvs, Re^Gvs, Re^Gvs, Re^Gvs
Ds, Ds, Ww, Ww, Wwf, Wwf, Gg, Gg, Ce, Rr, Rr^Vhc, Rr, Rr, Gs, Rr, 3 Kh, Kh, Rr, Rr, Rr^Vhc, Rr, Rr, Ce, Gg, Re^Gvs, Re^Gvs, Gs, Gs
Ww, Ww, Ww, Ww, Wwf, Gg, Gg, Gg, Ce, Rr, Rr, Gs, Rr, Rr, Rr, Kh, Rr^Vhc, Gg, Rr, Rr, Rr, Ce, Gs, Gg, Gs, Gs, Rr, Rr
Ww, Ww, Ww, Wwf, Gg, Gg, Gg, Gg, Gs, Ce, Rr, Rr, Rr, Rr^Vhc, Rr, Gg, Rr, Rr, Ce, Ce, Gs, Rr, Rr, Gs, Rr, Rr, Gs, Gs
Ww, Ww, Wwf, Wwf, Gg, Gg, Gg, Gs, Rr, Rr, Gs, Ce, Ce, Rr, Rr, Rr, Ce, Ce, Gg, Gg, Re^Gvs, Gs, Gs, Rr, Gs, Gs, Re^Gvs, Re^Gvs
Wwf, Wwf, Gg^Xo, Gg, Gg, Gg, Gs, Gs, Rr, Gs, Gg, Gg, Gg, Ce, Ce, Ce, Gg, Gg, Re^Gvs, Re^Gvs, Re^Gvs, Re^Gvs, Gg, Rr, Gg, Re^Gvs, Re^Gvs, Re^Gvs
Re^Gvs, Gg^Xo, Re^Xo, Re^Xo, Gs, Gs, Rr, 1 Rr, Gg, Gg, Re^Gvs, Re^Gvs, Re^Gvs, Gg, Ce, Gg, Re^Gvs, Re^Gvs, Re^Gvs, Re^Gvs, Re^Gvs, Re^Gvs, Gg, Rr, Gg, Re^Gvs, Re^Gvs, Re^Gvs
Re^Gvs, Re^Xo, Re^Xo, Re^Xo, Gs, Rr, Gg, Gg, Re^Gvs, Re^Gvs, Re^Gvs, Re^Gvs, Re^Gvs, Gg, Gg, Gg, Re^Gvs, Re^Gvs, Re^Gvs, Re^Gvs, Re^Gvs, Re^Gvs, Gg, Rr, Gg, Re^Gvs, Re^Gvs, Re^Gvs
Rd, Re^Gvs, Gg, Gg, Gs, Rr, Gg, Gg, Re^Gvs, Re^Gvs, Re^Gvs, Re^Gvs, Re^Gvs, Re^Gvs, Re^Gvs, Re^Gvs, Re^Gvs, Re^Gvs, Re^Gvs, Re^Gvs, Re^Gvs, Re^Gvs, Gg, Rr, Gg, Re^Gvs, Re^Gvs, Re^Gvs
