Mm, Mm, Ha, Ha, Mm, Ha, Ha, Aa^Fpa, Ha, Ha, Ha, Gg, Aa^Fpa, Aa, Aa^Fpa, Aa, Aa^Fpa, Aa^Fpa, Ha, Aa^Fpa, Ha, Aa^Fpa, Aa^Fpa, Gg, Ha, Aa^Fpa, Aa, Aa^Fpa, Aa^Fpa, Gg, Gg, Gg
Mm, Mm, Ha, Ha, Mm, Mm, Ha, Aa^Fma, Ha, Ha, Ha, Gg, Aa^Fma, Aa, Aa^Fpa, Aa, Aa^Fma, Aa^Fma, Ha, Aa^Fpa, Ha, Aa^Fpa, Aa^Fpa, Gg, Ha, Aa^Fpa, Aa, Aa^Fpa, Aa^Fpa, Gg, Gg, Gg
Mm, Mm, Mm, Mm, Mm, Mm, Ha, Gg, Ha, Mm, Gg, Aa^Fpa, Gg, Aa^Fma, Aa^Vca, Aa^Fpa, Aa, Gg, Aa^Fpa, Ha, Aa, Aa^Fpa, Aa, Ha, Ha, Ha, Aa^Fma, Aa^Fma, Ha, Gg, Gg, Gg
Ha, Ha, Aa^Fpa, Ha, Mm, Mm, Ha, Mm, Mm, Mm, Mm, Ha, Ha, Gg, Aa, Aa^Fpa, Aa^Fpa, Ce, 4 Ke, Aa^Fpa, Aa, Aa^Fpa, Aa^Fpa, Aa^Fpa, Aa, Aa, Aa^Fma, Gg, Ha, Aa, Aa^Fpa, Aa^Fpa
Aa, Aa, Aa^Fpa, Ha, Ha, Aa^Fpa, Aa^Fma, Ha, Ha, Mm, Ha, Gg, Aa^Fma, Ha, Gg, Aa^Fma, Aa^Fma, Aa^Fpa, Ce, Ce, Ce, Aa, Ha, Gg, Gg, Aa^Fpa, Aa, Ha, Aa^Fpa, Ha, Aa^Fma, Aa^Fpa
Gg, Gg, Aa^Fpa, Gg, Aa, Ha, Gg, Ha, Aa, Aa^Fma, Ha, Ha, Aa^Fma, Aa^Fma, Aa^Fpa, Aa^Fda, Aa, Aa^Fpa, Gg, Ce, Aa, Aa, Ha, Aa^Fpa, Gs^Vc, Aa, Aa^Fpa, Ha, Aa^Fpa, Gs^Fp, Aa, Aa
Aa^Fpa, Aa^Fpa, Ha, Aa^Fpa, Aa^Fda, Aa, Aa, Aa, Gg, Aa, Aa^Fda, Ha, Ha, Gg, Gg, Aa, Gg, Gs^Fp, Gg, Aa, Aa, Aa^Fpa, Aa^Fma, Ha, Aa, Aa^Fpa, Gg, Gg, Aa, Gg, Aa, Aa
Ha, Ha, Aa, Gg, Aa^Fda, Aa^Fma, Gg, Aa^Fpa, Gg, Gg, Aa^Vca, Aa, Aa^Fpa, Aa^Fpa, Gg, Aa^Fpa, Ha, Gs^Fmw, Gs^Fmw, Gg, Ha, Aa^Fma, Gs^Fdw, Aa, Ha, Aa^Fpa, Aa^Fpa, Aa, Aa^Fpa, Gg, Gg, Gg
Ha, Ha, Gg, Gg, Aa, Aa^Fma, Aa^Fpa, Aa, Ha, Aa, Aa^Fpa, Aa, Gg, Aa^Fpa, Aa^Fpa, Ha, Aa^Fpa, Ha, Gs^Fp, Gg, Ha, Ha, Aa^Fma, Gg, Gg, Ha, Aa^Fpa, Gg, Aa^Fma, Gg, Ww, Ai
Aa^Fpa, Aa^Fma, Aa^Fda, Gs^Fdw, Gs^Fdw, Ha, Ha, Ha, Aa, Aa^Fpa, Gg, Aa^Fpa, Aa^Fpa, Aa, Aa^Fpa, Aa^Fpa, Aa^Fpa, Gg, Aa^Fma, Aa^Fpa, Ha, Gg, Aa, Aa^Fma, Gg, Gs^Fp, Gg, Aa, Gs^Fp, Ai, Ww, Ww
Aa^Fpa, Aa^Fpa, Aa^Fma, Gs^Fdw, Gs^Fdw, Gs^Fmw, Gg, Gg, Aa, Aa, Aa^Fpa, Aa^Fpa, Aa, Aa, Ha, Gg, Gs^Vc, Aa^Fma, Gg, Ha, Gg, Gg, Aa, Aa^Fma, Aa^Fma, Aa^Fma, Gs^Fp, Aa^Vca, Gg, Ww, Ai, Ai
Aa, Aa, Aa^Fpa, Gg, Aa^Fda, Aa^Fda, Aa^Fpa, Aa^Fma, Aa^Fma, Aa^Vca, Gs^Fdw, Aa^Fpa, Aa^Fpa, Ha, Ha, Gg, Gs^Fdw, Gs^Fdw, Gg, Gg, Ai, Gg, Gg, Aa, Gg, Gs^Fp, Gg, Gg, Ww, Ww, Ai, Ai
Aa, Aa, Aa^Vca, Aa^Fma, Aa^Fma, Gg, Aa, Ha, Ha, Aa^Fma, Gs^Fdw, Gs^Fdw, Aa, Ha, Gs^Fp, Aa, Aa, Gg, Ww, Ww, Ww, Ww, Ww, Gg, Ai, Gg, Gg, Gg, Ww, Ai, Gg, Gg
Aa, Aa, Aa, Gg, Gs^Fmw, Aa, Aa^Fpa, Ha, Gg, Aa^Fpa, Aa^Fma, Aa^Fma, Aa, Aa^Fpa, Gg, Gg, Ww, Ww, Ai, Ai, Gg, Gg, Gg, Ww, Ww, Ai, Ww, Ww, Gg, Gg, Re^Gvs, Re^Gvs
Ai, Ai, Aa, Aa^Fpa, Aa, Aa, Gg, Gg, Gs^Fp, Gg, Gs^Fp, Gs^Fmw, Aa, Gg, Ai, Ai, Ww, Ai, Gs, Gs, Re^Gvs, Gg, Gs, Gg, Gg, Ww, Gg, Gs^Wm, Gg, Re^Gvs, Re^Gvs, Re^Gvs
Ww, Ai, Ai, Ww, Ww, Aa^Fpa, Gs^Fp, Gg, Gg, Aa, Aa, Aa, Ww, Aa, Ww, Ww, Gs, Ai, Gs, Gs, Gg^Gvs, Gs^Gvs, Re^Gvs, Gs, Gg, Gg, Gg^Gvs, Gs, Gg^Gvs, Re^Gvs, Gs, Gg
Ww, Ai, Ww, Ai, Ww, Ww, Ai, Gg, Ai, Gg, Ai, Ww, Ww, Ww, Gg, Gg^Vh, Gs, Gs, Gg, Gs^Gvs, Gg^Gvs, Gg^Gvs, Gg^Gvs, Gs^Gvs, Gs^Vh, Gg, Gg^Gvs, Gs^Gvs, Gg^Gvs, Gg, Rp, Gs
Ww, Wo, Ww, Ww, Ce, Ww, Ww, Ai, Ww, Ai, Ww, Ww, Gg, Gg, Re^Gvs, Gg, Gg^Gvs, Gs^Gvs, Re^Gvs, Gg^Gvs, Gg^Gvs, Gg^Gvs, Gs, Ww, Gg, Gg, Gs, Gs, Rp, Rp, Gs^Vh, Gg
Ww, Ww, Ce, Ce, 1 Ke, Ce, Ce, Ww, Gg, Ww, Gg, Gg, Rp, Gs, Gg, Re^Gvs, Re^Gvs, Gg^Gvs, Re^Gvs, Re^Gvs, Gs^Gvs, Gs^Gvs, Gs, Gg, Gs, Gs, Gs, Rp, Gs, Gg, Gg, Gg
Gg, Gg, Rp, Rp, Rp, Gs, Rp, Rp, Rp, Gs, Gs, Rp, Gg^Gvs, Rp, Gs, Gg, Gg, Re^Gvs, Re^Gvs, Gg^Gvs, Re^Gvs, Re^Gvs, Gs, Gg, Gs, Gs, Gg, Gg, Gs^Gvs, Gs, Gg^Gvs, Gg
Rp, Rp, Gg, Gg, Gg, Rp, Gg, Gg, Ww, Gg^Vh, Gg, Gg^Gvs, Gg^Gvs, Gg, Gs, Gs, Rp, Gg, Gg, Re^Gvs, Gs, Gg^Gvs, Gs, Gs, Gs, Rp, Gd^Fetd, Gg^Gvs, Gg^Gvs, Gs^Gvs, Gg, Re^Gvs
Gs, Gs^Xo, Re^Xo, Re^Gvs, Re^Gvs, Gs, Re^Gvs, Re^Gvs, Re^Gvs, Gg, Gg^Gvs, Gg^Gvs, Gg^Gvs, Gg^Gvs, Gs, Gs, Gd^Fetd, Rp, Gs, Gg, Gs^Gvs, Gs^Gvs, Gg, Gs, Gs, Rp, Gs^Gvs, Gg, Re^Gvs, Gs^Gvs, Gg^Gvs, Re^Gvs
Gs, Re^Xo, Gs^Xo, Gs^Xo, Gs^Gvs, Re^Gvs, Gs^Gvs, Re^Gvs, Re^Gvs, Gg^Gvs, Gg^Gvs, Gg^Gvs, Gs^Gvs, Gs, Rp, Gs, Re^Gvs, Gg, Gg, Rp, Gs, Gs^Gvs, Rp, Gs, Gs, Gs, Gs^Gvs, Gg^Gvs, Gs, Re^Gvs, Gg, Re^Gvs
Gs, Re^Xo, Re^Xo, Re^Xo, Re^Gvs, Re^Gvs, Re^Gvs, Re^Gvs, Gg, Gg, Gs, Gs, Gs, Rp, Gs, Gs, Re^Gvs, Gg, Gs, Gs, Gg, Rp, Gs, Gs^Gvs, Gg^Gvs, Re^Gvs, Gg, Gg^Gvs, Gg, Gg^Gvs, Re^Gvs, Re^Gvs
Gs, Gs^Xo, Gs^Xo, Gs^Xo, Gs^Gvs, Re^Gvs, Re^Gvs, Gg, Gg^Vh, Gs, Rp, Rp, Re^Gvs, Re^Gvs, Re^Gvs, Re^Gvs, Gs^Gvs, Gg, Ww, Gg^Vh, Gg, Gg, Gg^Gvs, Gs^Gvs, Gs^Gvs, Gg^Gvs, Gg, Gg, Gs, Re^Gvs, Re^Gvs, Re^Gvs
Re^Gvs, Re^Xo, Re^Xo, Re^Xo, Re^Gvs, Gs^Gvs, Re^Gvs, Ww, Gg, Gg, Re^Gvs, Re^Gvs, Re^Gvs, Re^Gvs, Re^Gvs, Gs^Gvs, Re^Gvs, Re^Gvs, Re^Gvs, Gg, Re^Gvs, Re^Gvs, Re^Gvs, Gg^Gvs, Gg^Gvs, Gs^Gvs, Gs, Gs, Gs, Re^Gvs, Re^Gvs, Re^Gvs
Re^Gvs, Re^Gvs, Re^Gvs, Gs, Re^Gvs, Re^Gvs, Re^Gvs, Gg, Gg, Gg, Re^Gvs, Re^Gvs, Gs, Re^Gvs, Gs, Re^Gvs, Re^Gvs, Re^Gvs, Re^Gvs, Re^Gvs, Re^Gvs, Re^Gvs, Re^Gvs, Re^Gvs, Re^Gvs, Gg, Gg, Gs, Rr, Gg, Gg, Re^Gvs
