Gg, Gg, Gg, Gg^Xo, Aa^Fpa, Aa^Fdw, Aa^Fma, Ha, Ha, Gg, Aa^Fpa, Aa^Fpa, Aa^Fdw, Gg, Ha, Aa, Aa, Gg, Ds, Ai, Ww, Ww, Ai, Wo, Wo, Wo, Wo, Wo, Wo, Wo, Wo, Wo, Wo, Wo, Wo, Wo, Wo, Wo, Wo, Wo, Wo, Wo, Wo, Wo, Wo, Wo, Wo, Wo, Wo, Wo
Gg, Aa^Fma, Gg, Gg^Xo, Aa^Fpa, Aa^Fma, Aa^Fdw, Ha, Ha, Gg, Aa^Fpa, Aa^Fma, Aa^Fdw, Gs, Ha, Aa, Aa, Gg, Ds, Ai, Ww, Ww, Ai, Wo, Wo, Wo, Wo, Wo, Wo, Wo, Wo, Wo, Wo, Wo, Wo, Wo, Wo, Wo, Wo, Wo, Wo, Wo, Wo, Wo, Wo, Wo, Wo, Wo, Wo, Wo
Gg, Gll^Fdw, Aa^Fma, Ha^Xo, Gs^Fp, Gs^Fmw, Aa^Fdw, Aa^Fma, Gg, Gs^Fp, Aa^Fpa, Aa^Fpa, Aa^Fpa, Ha, Ha, Ha, Ds, Gg, Ds, Ai, Ww, Wo, Ai, Ai, Wo, Wo, Wo, Wo, Wo, Wo, Wo, Wo, Wo, Wo, Wo, Wo, Wo, Wo, Wo, Wo, Wo, Wo, Wo, Wo, Wo, Wo, Wo, Wo, Wo, Wo
Gll^Fdw, Gg, Gll^Fdw, Gg^Xo, Gs^Fp, Gs^Fp, Gs, Gs, Ha, Aa^Fpa, Aa^Fdw, Aa^Fma, Aa^Fdw, Aa^Vca, Ha, Ha, Ds, Ds, Ds, Ai, Ai, Ww, Wo, Wo, Wo, Wo, Wo, Wo, Wo, Wo, Wo, Wo, Wo, Wo, Wo, Wo, Wo, Wo, Wo, Wo, Wo, Wo, Wo, Wo, Wo, Wo, Wo, Wo, Wo, Wo
Gg, Gg, Ha, Gg^Xo, Gll^Fdw, Aa^Fma, Ha, Ha, Ha, Gg, Ha, Ha, Aa, Gs^Fmw, Aa^Fma, Ds, Ds, Ds, Ds, Ds, Ce, Ww, Ww, Wo, Wo, Wo, Wo, Wo, Wo, Wo, Wo, Wo, Wo, Wo, Wo, Wo, Wo, Wo, Wo, Wo, Wo, Wo, Wo, Wo, Wo, Wo, Wo, Wo, Wo, Wo
Gg, Gg, Ha, Ha^Xo, Gg, Gg, Gs^Fp, Gs, Aa^Fpa, Gs, Ha, Ha, Aa^Fpa, Gs^Fdw, Gs, Ds, Ds, Ds, Ds, Ce, Dd^Vda, Ww, Ww, Ww, Wo, Wo, Wo, Wo, Wo, Wo, Wo, Wo, Wo, Wo, Wo, Wo, Wo, Wo, Wo, Wo, Wo, Wo, Wo, Wo, Wo, Wo, Wo, Wo, Wo, Wo
Gg, Gg, Aa^Fma, Aa^Xo, Gs^Fp, Gs^Fp, Gs^Vc, Aa^Fpa, Aa^Fpa, Ha, Ha, Aa^Fma, Gs^Fmw, Aa^Fpa, Ha, Ds, Ds, Ds, Ds, Ce, Ce, Rr, Ww^Bw\, Ww, Ww, Wo, Wo, Wo, Wo, Wo, Wo, Wo, Wo, Wo, Wo, Wo, Wo, Wo, Wo, Wo, Wo, Wo, Wo, Wo, Wo, Wo, Wo, Wo, Wo, Wo
Gg, Aa^Fma, Gg, Ha^Xo, Ha, Gg, Aa^Fpa, Aa^Fma, Aa^Fma, Aa^Fpa, Gg, Aa^Fpa, Aa^Fpa, Ha, Ha, Ds, Ds, Ds, Ds, Ds, Ww, Ww, Ww, Ww^Bw\, Rr, Ww, Ww, Wo, Ww, Wo, Wo, Wo, Wo, Wo, Wo, Wo, Wo, Wo, Wo, Wo, Wo, Wo, Wo, Wo, Ww, Wo, Ww, Wo, Wo, Wo
Gg, Gll^Fdw, Gll^Fmw, Hh^Xo, Aa^Fma, Gg, Gs^Fp, Chr, Chr, Aa^Fpa, Gs^Vc, Aa^Fma, Gs^Fp, Ha, Gs^Fp, Ha, Gg, Ds, Ww, Ww, Ww, Ww, Ww, Ww, Ww^Bw|, Ww, Ww, Ww, Ww, Ww, Wo, Wo, Wo, Wo, Wo, Wo, Wo, Wo, Wo, Wo, Wo, Wo, Wo, Ww, Ww, Ai, Ai, Ww, Ww, Ww
Gg, Gll^Fdw, Aa^Fma, Aa^Xo, Aa^Fma, Gs^Fp, Aa^Fpa, 4 Kh, Chr, Ha, Aa^Fma, Aa^Fdw, Aa, Gs^Fmw, Gs^Fp, Gs^Fp, Aa, Ds, Ww, Ww, Wo, Ww, Ww, Ww, Ww^Bw|, Ww, Ch, Ww, Ww, Ww, Ww, Wo, Wo, Wo, Wo, Wo, Wo, Wo, Wo, Wo, Wo, Wo, Wo, Ww, Ds, Ds, Ai, Ai, Ww, Ww
Gg, Gg, Aa^Fma, Gg^Xo, Gs^Fp, Gs^Fmw, Gs^Fmw, Chr, Aa^Fma, Chr, Aa^Fma, Aa^Fpa, Ha, Aa, Aa, Aa, Ds, Ds, Ww, Wo, Wo, Wo, Ww, Ww, Rr, Ch, Rr, Ch, Rr, Ww, Ww, Wo, Wo, Wo, Wo, Wo, Wo, Wo, Ww, Ww, Ww, Ww, Ww, Ww, Ds, Ds, Ds, Ds, Ds, Ds
Gg, Gll^Fdw, Gg, Gll^Xo, Gs^Fp, Gs^Fmw, Gs^Fp, Gs^Vc, Aa^Fdw, Aa^Fma, Gg, Gs^Fp, Aa, Ha, Gg, Gs, Ds, Ww, Ww, Wo, Wo, Wo, Ww, Ww, Ch, Rrc, Rr^Vhc, Rr, Rrc, Ww, Ww, Wo, Wo, Wo, Wo, Wo, Wo, Ww, Ds, Ds, Ds, Ww, Ds, Ds, Gg, Gg, Aa^Fpa, Gg, Aa^Fpa, Aa^Fpa
Gg, Gg, Gg, Hh^Xo, Gg, Gg, Ha, Gs^Fp, Aa^Fpa, Gg, Gs, Gs^Fmw, Aa^Fma, Aa^Fdw, Hh, Gs, Gg, Ds, Ww, Wo, Ww, Wo, Ww, Ww, Ww, Rrc, Ch, Ch, Ch, Rr, Rr, Ww^Bw/, Ww^Bw\, Wo, Wo, Wo, Ww, Ww, Ds, Ds, Rr, Ds, Ds, Ds, Gg, Aa^Fpa, Gs^Fp, Gs^Fp, Aa^Fpa, Aa^Fpa
Gg, Hh, Gll^Fmw, Gg^Xo, Gg, Aa^Fma, Ha, Aa, Aa^Fpa, Aa^Fma, Gs^Vc, Gs, Aa^Fma, Hh, Gs^Fdw, Aa, Aa, Ds, Gs, Ww, Wwf, Ww, Wo, Ww, Ww, Rr, Rr^Vhc, 3 Kh, Ch, Rr^Vhc, Rrc, Ch, Ww, Wo^Bw\, Wo^Bw\, Wo, Ww, Ds, Ds, Ds, Ds, Rr, Rrc, Ce, Gg, Gs^Fp, Hh, Gg, Gs^Fp, Gs^Fp
Gg, Gll^Fmw, Gg, Gg^Xo, Hh, Gg, Gs^Fmw, Aa, Aa, Aa^Fpa, Gs^Fp, Gg, Aa^Fpa, Hh, Gs^Fmw, Gg, Aa, Gg, Gs, Wwf, Ds, Wwf, Wo, Ww, Ww, Ch, Rr, Ch, Rrc, Rr, Ww, Ww, Ww, Wo, Wo, Wo^Bw\, Ww^Bw\, Ww, Ww, Ds, Gg, Rr^Vhc, Rrc, Ce, Gg, Gg, Hh, Gg, Gs^Fp, Gs^Fp
Gll^Fmw, Gll^Fmw, Gg, Gg^Xo, Aa^Fma, Gs, Gs^Fp, Hh, Aa, Gg, Gs, Gs, Gg, Aa^Fpa, Gs, Gs, Gs, Gg, Gg, Gs, Ds, Wwf, Wwf, Ww, Ww, Ch, Ch, Rr, Ww^Bsb|, Ch, Ww, Ww, Wo, Wo, Wo, Wo, Ww, Ww^Bw\, Rrc, Gg, Gs, Gg, Rr, Ce, Gg, Gs^Fp, Gs^Fp, Gg, Gg, Gg
Gg, Gg, Gg, Gll^Xo, Gg, Aa^Fma, Aa^Fpa, Gs, Hh, Gs^Fp, Aa^Fpa, Aa^Fma, Gg, Gs^Fmw, Gg, Gs^Fmw, Gs^Fdw, Gs^Fmw, Gg, Gg, Gg, Ds, Wwf, Ww, Wo, Ww, Ww, Ww, Wo^Bsb|, Ww, Wo, Wo, Wo, Wo, Wo, Wo, Ww, Ww, Ww^Bw/, Rrc, Rrc, Gs, Rrc, Gg, Gg, Gg, Gs^Fp, Hh, Hh, Hh
Gg, Gg, Gg, Gll^Xo, Gll^Fmw, Aa^Fma, Gs^Fp, Gs^Fp, Gs^Vc, Gs^Fp, Gs, Gg, Aa^Fdw, Gs^Fp, Hh, Gs, Gg, Gs^Fdw, Gs, Gg, Gg, Gs, Gs, Ww, Wo, Wo, Ww, Wo, Ww^Bsb|, Wo, Ww, Wo, Ww, Wo, Wo, Wo, Ww, Ww, Ww, Wwf, Ds, Rrc, Rrc, Gg, Gg, Gg, Gg, Hh, Hh, Hh
Gg, Gll^Fmw, Gg, Gg^Xo, Gs^Fp, Gs^Fp, Gll^Fmw, Aa^Fma, Gs^Fp, Gs, Aa^Fma, Hh, Hh, Gg, Hh, Hh, Gs^Fp, Gs, Gg, Gg, Gg, Wwf, Ww, Wo, Ww, Ww, Ww, Ww, Ww^Bsb|, Ww, Ds, Ww, Ww, Ww, Ww, Ww, Ww, Ww, Ww^Bw\, Ds, Rr^Vhc, Gg, Rrc, Gs, Gs, Gg, Gs^Fp, Hh, Hh, Hh
Gg, Gg, Gll^Fmw, Gg^Xo, Gg, Gs, Gs, Gg, Gs^Fmw, Gs^Fp, Gg, Aa^Fma, Gs^Fmw, Hh, Gs, Gs^Vc, Hh, Gg, Gg, Gg, Ww, Ww, Wo, Wo, Wwf, Wwf, Ds, Ds, Rrc, Ds, Gs, Ww^Bw/, Ww, Ww, Ww, Ww, Ww^Bw|, Ww, Ds, Ds, Rr, Rrc, Ce, Rrc, Rr, Gg, Gg, Gg, Hh, Hh
Gg, Gg, Gg, Gg^Xo, Gll^Fmw, Gll^Fmw, Gg, Gs^Fdw, Gs^Fmw, Gs, Gs^Fp, Aa^Fdw, Gs^Fp, Gs^Fp, Hh, Hh, Gs, Gg, Ds, Ww, Ww, Ww, Wo, Wwf, Wwf, Ce, Gg, Rr^Vhc, Rrc, Gs, Gg, Ds, Ds, Ww^Bw|, Ds, Ds, Gs, Ds, Rr^Vhc, Rr, Ce, Ce, Gg, Gs, Rr, Gs^Fp, Gs^Fp, Re^Vct, Gs^Fp, Gs^Fp
Gg, Gg, Gll^Fdw, Gll^Xo, Gs^Fp, Gs^Fp, Gs^Fp, Gs^Fdw, Gs, Gs^Fp, Gg, Gs, Gs, Gs^Fp, Gs, Hh, Gg, Gg, Ds, Ww, Ww, Ww, Ww, Ww, Gg, Ce, Ce, Gg, Rr, Gg, Rrc, Rr^Vhc, Gg, Gs, Gg, Gg, Gs, Gg, Rrc, Rr, Gg, Gg, Gg, Gs, Rr, Gg, Gg, Gs^Fp, Gs^Fp, Gs^Fp
Gg, Gg, Gll^Fdw, Gll^Xo, Gs, Gg, Gs, Gs^Fp, Gs^Fp, Gs^Fp, Gg, Gs^Fmw, Gg, Gg, Gg, Gg, Wwf, Ds, Ww, Ww, Wo, Ww, Gg, Gg, Gg, Gs, Gg, Gg, Ce, Rr, Rrc, Gg, Gg, Gs, Rr^Vhc, Gg, Rr, Rr, Ce, Gg, Gg, Gg, Re^Gvs, Gs, Rr, Gs^Fp, Gs^Fp, Gg, Gs^Fp, Gs^Fp
Gg, Hh, Gg, Gg^Xo, Gg, Gs, Gg, Gs^Vc, Gs, Gs^Fmw, Gs^Fp, Gs^Fdw, Gg, Gg, Gg, Gg, Wwf, Ww, Wo, Wo, Ww, Ww, Gg, Gg, Gg, Gg, Gg, Gg, Gg, Ce, Ce, Rr, Rr, Rrc, Rr, Rr, Ce, Ce, Gg, Gg, Re^Gvs, Re^Gvs, Re^Gvs, Gs, Gg, Rr, Rr, Gg, Gg, Gg
Gg, Hh, Hh, Gg^Xo, Gg, Gg, Hh, Hh, Gg, Gg, Hh, Gs, Ww, Gg, Ww, Ww, Ww, Ww, Ww, Ww, Ww, Gg, Gg, Gg, Hh, Hh, Gg, Gg, Gg, Gg, Gg, Rrc, Rr, Ce, Ce, Ce, Gg, Gg, Re^Gvs, Re^Gvs, Re^Gvs, Re^Gvs, Re^Gvs, Re^Gvs, Re^Gvs, Gg, Gg, Rr, Rr, Rr
Hh, Gg, Hh, Gs^Xo, Hh, Gg, Hh, Hh, Gg, Gg, Gg, Ww, Ww, Ww, Ww, Ww, Ww, Ww, Gg, Ww, Gg, Gg, Hh, Hh, Hh, Hh, Gg, Gg, Gs, Gg, Gs, Rr, Rr, Gg, Gg, Gg, Re^Gvs, Re^Gvs, Re^Gvs, Re^Gvs, Re^Gvs, Re^Gvs, Re^Gvs, Re^Gvs, Re^Gvs, Re^Gvs, Gg, Gg, Gg, Gg
Gg, Gg, Gg, Hh^Xo, Hh, Hh, Hh, Hh, Wwf, Gg, Ww, Ww, Wo, Wo, Ww, Ww, Ww, Ww, Gg, Gg, Re^Gvs, Hh, Hh, Hh, Hh, Hh, Gs, Gs, Rr, Gs, Rr, Rr, Gg, Gg, Re^Gvs, Re^Gvs, Re^Gvs, Re^Gvs, Gg, Re^Gvs, Re^Gvs, Re^Gvs, Re^Gvs, Re^Gvs, Gs, Gs, Re^Gvs, Re^Gvs, Re^Gvs, Re^Gvs
Gg, Gg, Gg, Gg^Xo, Gg, Gg, Gg, Hh, Re, Wwf, Ww, Wo, Ww, Ww, Gg, Gg, Hh, Gg, Gg, Re^Gvs, Re^Gvs, Re^Gvs, Re^Gvs, Hh, Gg, Gs, Rr, Rr, Ce, Rr, Gg, Gg, Re^Gvs, Re^Gvs, Re^Gvs, Re^Gvs, Re^Gvs, Gg, Gg^Vh, Ww, Re^Gvs, Re^Gvs, Gg, Gs, Re^Gvs, Re^Gvs, Re^Gvs, Re^Gvs, Re^Gvs, Re^Gvs
Hh, Gg, Gs^Fms, Gs^Xo, Gg, Hh, Gg, Gg, Gg, Ww, Ww, Wo, Ww, Ww, Hh, Hh, Hh, Gg, Gg^Vh, Gg, Re^Gvs, Re^Gvs, Re^Gvs, Re^Gvs, Gg, Rr, Gg, Ce, Rr^Vhc, Ce, Gg, Re^Gvs, Re^Gvs, Re^Gvs, Re^Gvs, Re^Gvs, Re^Gvs, Gg, Gg, Gg, Gs, Gs, Re^Gvs, Re^Gvs, Re^Gvs, Re^Gvs, Re^Gvs, Re^Gvs, Re^Gvs, Re^Gvs
Gs^Fms, Gg, Hh, Gg^Xo, Hh, Hh, Hh, Gg, Re, Ww, Ww, Ww, Ww, Wwf, Gg, Gg, Gg, Gg, Gg, Ww, Re^Gvs, Re^Gvs, Gg, Gg, Rr, Rr, Gg, Ce, Ce, Ket, Gg, Re^Gvs, Re^Gvs, Re^Gvs, Re^Gvs, Re^Gvs, Re^Gvs, Re^Gvs, Gs, Gg, Re^Gvs, Re^Gvs, Re^Gvs, Re^Gvs, Re^Gvs, Re^Gvs, Re^Gvs, Re^Gvs, Re^Gvs, Re^Gvs
Gg, Hh, Hh, Gg^Xo, Gg, Gg, Hh, Hh, Gg, Ww, Ww, Wo, Ww, Wwf, Gg, Re^Gvs, Re^Gvs, Re^Gvs, Re^Gvs, Re^Gvs, Re^Gvs, Re^Gvs, Gg, Rr, Gs, Gs, Gg, Gg, Gg, Gg, Gg, Re^Gvs, Re^Gvs, Re^Gvs, Re^Gvs, Re^Gvs, Gg, Gg, Re^Gvs, Re^Gvs, Re^Gvs, Re^Gvs, Re^Gvs, Re^Gvs, Re^Gvs, Re^Gvs, Re^Gvs, Re^Gvs, Re^Gvs, Re^Gvs
Gg, Gg, Gg, Hh^Xo, Hh, Hh, Hh, Hh, Gg, Ww, Ww, Wo, Wo, Ww, Gg, Re^Gvs, Hh, Hh, Re^Gvs, Re^Gvs, Gg, Gg, Gs, Rr, Gg, Re^Gvs, Re^Gvs, Re^Gvs, Re^Gvs, Gg, Re^Gvs, Gg, Gs, Re^Gvs, Gg, Gg, Re^Gvs, Re^Gvs, Re^Gvs, Re^Gvs, Re^Gvs, Re^Gvs, Gg, Re^Gvs, Re^Gvs, Re^Gvs, Re^Gvs, Re^Gvs, Re^Gvs, Re^Gvs
Gg, Gg, Gg, Gs^Xo, Gs^Fms, Gs^Fms, Hh, Hh, Gg, Wwf, Ww, Wo, Ww, Ww, Gg, Re^Gvs, Hh, Hh, Re^Gvs, Gg, Ket, Ce, Ce, Rr, Gg, Re^Gvs, Re^Gvs, Re^Gvs, Re^Gvs, Re^Gvs, Re^Gvs, Re^Gvs, Re^Gvs, Gs, Gg, Re^Gvs, Re^Gvs, Re^Gvs, Re^Gvs, Re^Gvs, Re^Gvs, Gg, Gg^Vh, Gg, Re^Gvs, Re^Gvs, Re^Gvs, Re^Gvs, Re^Gvs, Re^Gvs
Ww, Gg, Re, Gg^Xo, Re, Gg, Gg, Gs^Vc, Gg, Wwf, Wwf, Ww, Ww, Ww, Re, Gg, Gg, Re^Gvs, Gg, Gg, Ce, Rr^Vhc, Ce, Rr, Gg, Re^Gvs, Re^Gvs, Re^Gvs, Re^Gvs, Re^Gvs, Re^Gvs, Re^Gvs, Re^Gvs, Re^Gvs, Re^Gvs, Gg, Gg, Re^Gvs, Re^Gvs, Re^Gvs, Re^Gvs, Gg, Gg, Ww, Re^Gvs, Re^Gvs, Re^Gvs, Re^Gvs, Re^Gvs, Re^Gvs
Ww, Ww, Ww, Ww^Xo, Ww, Re, Gg, Gg, Gg, Re, Ww, Ww, Ww, Re, Gg, Gg, Gg, Gg, Rr, Gg, Rr, Ce, Rr, Rr, Gg, Re^Gvs, Re^Gvs, Re^Gvs, Re^Gvs, Re^Gvs, Re^Gvs, Re^Gvs, Re^Gvs, Re^Gvs, Re^Gvs, Re^Gvs, Re^Gvs, Gs, Gg, Re^Gvs, Re^Gvs, Re^Gvs, Re^Gvs, Re^Gvs, Re^Gvs, Re^Gvs, Re^Gvs, Re^Gvs, Re^Gvs, Re^Gvs
Ww, Wo, Ww, Ww^Xo, Ww, Ww, Ww, Ww, Ww, Ww, Wo, Wo, Ww, Gg, Gg, Gg, Rr, Rr, Gs, Rr, Gg, Rr, Gg, Gg, Re^Gvs, Re^Gvs, Re^Gvs, Re^Gvs, Re^Gvs, Re^Gvs, Gg, Re^Gvs, Re^Gvs, Re^Gvs, Re^Gvs, Re^Gvs, Re^Gvs, Re^Gvs, Re^Gvs, Gg, Gg, Re^Gvs, Re^Gvs, Re^Gvs, Re^Gvs, Re^Gvs, Re^Gvs, Re^Gvs, Re^Gvs, Re^Gvs
Gg, Ww, Ww, Ww^Xo, Ww, Wo, Wo, Ww, Ww, Wo, Ww, Ww, Gg, Gg, 1 Gg, Gs, Rr, Gs, Gg, Gg, Re^Gvs, Gg, Re^Gvs, Re^Gvs, Re^Gvs, Re^Gvs, Re^Gvs, Re^Gvs, Re^Gvs, Gg, Gg^Vh, Ww, Re^Gvs, Re^Gvs, Re^Gvs, Re^Gvs, Re^Gvs, Re^Gvs, Re^Gvs, Re^Gvs, Re^Gvs, Gs, Gs, Re^Gvs, Re^Gvs, Re^Gvs, Re^Gvs, Re^Gvs, Re^Gvs, Re^Gvs
Gg, Gg, Gg, Gg^Xo, Gg, Ww, Gg, Ww, Gs, Ww, Gg, Gs, Gg, Gs, Gs, Rr, Gg, Gg, Re^Gvs, Re^Gvs, Re^Gvs, Re^Gvs, Re^Gvs, Re^Gvs, Re^Gvs, Re^Gvs, Re^Gvs, Re^Gvs, Re^Gvs, Gg, Gg, Gg, Re^Gvs, Re^Gvs, Re^Gvs, Re^Gvs, Re^Gvs, Re^Gvs, Re^Gvs, Re^Gvs, Re^Gvs, Re^Gvs, Re^Gvs, Gs, Gg, Re^Gvs, Re^Gvs, Re^Gvs, Re^Gvs, Re^Gvs
Gg, Gs, Gg, Gs^Xo, Gs, Gg, Gg, Gs, Gg, Gg, Gg, Gg, Gs, Gs, Rr, Rr, Gg, Re^Gvs, Rb^Gvs, Rb^Gvs, Re^Gvs, Re^Gvs, Re^Gvs, Re^Gvs, Re^Gvs, Re^Gvs, Re^Gvs, Re^Gvs, Re^Gvs, Re^Gvs, Re^Gvs, Re^Gvs, Re^Gvs, Re^Gvs, Re^Gvs, Re^Gvs, Re^Gvs, Re^Gvs, Re^Gvs, Re^Gvs, Re^Gvs, Re^Gvs, Re^Gvs, Re^Gvs, Re^Gvs, Gg, Gg, Re^Gvs, Re^Gvs, Re^Gvs
Gg, Gg, Gg, Gg^Xo, Gg, Gs, Gg, Gg, Gs, Gs, Gg, Gs, Rr, Rr, Gg, Gg, Gg, Re^Gvs, Gg, Gg^Gvs, Re^Gvs, Re^Gvs, Re^Gvs, Re^Gvs, Re^Gvs, Re^Gvs, Re^Gvs, Re^Gvs, Re^Gvs, Re^Gvs, Re^Gvs, Re^Gvs, Re^Gvs, Re^Gvs, Re^Gvs, Re^Gvs, Re^Gvs, Re^Gvs, Re^Gvs, Re^Gvs, Re^Gvs, Re^Gvs, Re^Gvs, Re^Gvs, Re^Gvs, Gg, Gg, Re^Gvs, Re^Gvs, Re^Gvs
