border_size=1
usage=map

Hh          ,Hh          , Gs^Fp       , Mm          , Mm          , Hh          , Hh          , Hh          , Mm          , Mm          , Mm          , Gs^Fp       , Gs^Fp       , Mm          , Mm          , Gs^Fp       , Gs^Fp       , Hh          , Hh          , Hh          , Hh          , Hh          , Ww          , Ww          , Ww          , Ww          , Gs^Fp       , Gs^Fp       , Mm          , Mm          , Mm          , Mm          , Mm          
Hh          ,Hh          , Gs^Fp       , Mm          , Mm          , Hh          , Hh          , Hh          , Mm          , Mm          , Mm          , Gs^Fp       , Gs^Fp       , Mm          , Mm          , Gs^Fp       , Gs^Fp       , Hh          , Hh          , Hh          , Hh          , Hh          , Ww          , Ww          , Ww          , Ww          , Gs^Fp       , Gs^Fp       , Mm          , Mm          , Mm          , Mm          , Mm          
Hh          ,Hh          , Gs^Fp       , Mm          , Mm^Vhh      , Mm          , Gs^Fp       , Hh          , Mm          , Mm          , Mm          , Gs^Fp       , Gs^Fp       , Mm          , Mm          , Gs^Fp       , Gs^Fp       , Hh          , Gs^Fp       , Hh          , Hh          , Ww^Vm       , Ww          , Ww          , Ww          , Ww          , Gs^Fp       , Gs^Fp       , Mm          , Mm          , Mm^Vhh      , Gs^Fp       , Gs^Fp       
Gs^Fp       ,Gs^Fp       , Gs^Fp       , Mm          , Mm          , Mm          , Gs^Fp       , Mm          , Gs^Fp       , Mm          , Mm          , Gs^Fp       , Gs^Fp       , Gs^Fp       , Mm          , Gs^Fp       , Gs^Fp       , Gs^Fp       , Gs^Fp       , Gs^Fp       , Ww          , Ww          , Ww          , Ww          , Ww          , Gs^Fp       , Ce          , Ce          , Mm          , Mm          , Mm          , Mm          , Mm          
Gs^Fp       ,Gs^Fp       , Hh          , Hh          , Gs^Fp       , Gs^Fp       , Gs^Fp       , Hh          , Hh          , Gs^Fp       , Hh          , Mm          , Mm          , Mm          , Mm^Vhh      , Mm          , Mm          , Mm          , Hh          , Gs^Fp       , Ww          , Ww          , Ww          , Ww          , Hh          , Gs^Fp       , Ce          , Ce          , Ce          , Mm          , Mm          , Mm          , Mm          
Hh          ,Hh          , Mm          , Gs^Fp       , Hh          , Hh          , Gs^Fp       , Gs^Fp       , Ww          , Ww          , Ww          , Ww          , Ww          , Mm          , Mm          , Mm          , Mm          , Hh          , Hh          , Ww          , Ww          , Ww          , Ww          , Ww          , Hh          , Gs^Fp       , Gs^Fp       , Ce          , Mm          , Gs^Fp       , Mm          , Mm          , Mm          
Hh          ,Hh          , Gs^Fp       , Mm          , Hh          , Gs^Fp       , Ww          , Ww          , Ww^Bw/      , Ww^Bw\      , Kh          , Ww^Bw/      , Ww^Bw\      , Ww          , Ww          , Mm          , Gs^Fp       , Hh          , Ww          , Ww          , Ww          , Ww          , Gs^Fp       , Gs^Fp       , Gs^Fp       , Gs^Fp       , Mm          , Gs^Fp       , Mm          , Gs^Fp       , Gs^Fp       , Gs^Fp       , Gs^Fp       
Mm          ,Mm          , Hh          , Mm          , Ww          , Ww          , Ww^Bw/      , Kh          , Gs^Fp       , Gs^Fp       , Gs^Fp       , Gs^Fp       , Gs^Fp       , Kh          , Ww^Bw\      , Ww          , Ww          , Ww          , Ww          , Ww          , Hh          , Gs^Fp       , Gs^Fp       , Mm          , Hh          , Hh          , Gs^Fp       , Mm          , Gs^Fp       , Mm          , Gs^Fp       , Gs^Fp       , Gs^Fp       
Mm          ,Mm          , Hh          , Mm          , Ww          , Ww^Bw|      , Gs^Fp       , Gs^Fp       , Gs^Fp       , Mm          , Mm          , Mm          , Gs^Fp       , Gs^Fp       , Gs^Fp       , Ww^Bw|      , Ww          , Ww          , Hh          , Hh          , Mm          , Gs^Fp       , Mm          , Mm          , Hh          , Hh          , Mm          , Gs^Fp       , Mm          , Mm          , Mm          , Mm          , Mm          
Mm          ,Mm          , Mm          , Ww          , Ww^Bw/      , Kh          , Gs^Fp       , Mm          , Mm^Xm       , Mm^Xm       , Mm          , Mm^Xm       , Mm^Xm       , Mm          , Gs^Fp       , Kh          , Ww^Bw\      , Ww          , Hh          , Mm          , Mm          , Gs^Fp       , Mm          , Mm^Vhh      , Mm          , Gs^Fp       , Gs^Fp       , Gs^Fp       , Hh          , Gs^Fp       , Gs^Fp       , Gs^Fp       , Gs^Fp       
Mm          ,Mm          , Gs^Fp       , Ww          , 1 Ww^Bw|    , Gs^Fp       , Mm          , Mm          , Mm          , Mm^Xm       , Kh          , Mm^Xm       , Mm          , Mm          , Mm          , Gs^Fp       , Ww^Bw|      , Ww          , Ww          , Hh          , Hh          , Mm          , Mm          , Mm          , Mm          , Mm          , Gs^Fp       , Hh          , Hh          , Mm          , Mm          , Gs^Fp       , Gs^Fp       
Gs^Fp       ,Gs^Fp       , Gs^Fp       , Ww          , Kh          , Gs^Fp       , Gs^Fp       , Mm^Xm       , Mm^Xm       , Kh          , Mm^Xm       , Kh          , Mm^Xm       , Mm^Xm       , Gs^Fp       , Gs^Fp       , Kh          , Ww          , Gs^Fp       , Hh          , Mm          , Gs^Fp       , Hh          , Hh          , Gs^Fp       , Gs^Fp       , Hh          , Hh          , Mm          , Gs^Fp       , Gs^Fp       , Gs^Fp       , Gs^Fp       
Hh          ,Hh          , Gs^Fp       , Ww          , Ww^Bw|      , Gs^Fp       , Mm          , Mm^Xm       , Mm          , Kh          , Kh          , Kh          , Mm          , Mm^Xm       , Mm          , Gs^Fp       , Ww^Bw|      , Ww          , Gs^Fp       , Mm          , Mm          , Gs^Fp       , Gs^Fp       , Hh          , Hh          , Gs^Fp       , Gs^Fp       , Gs^Fp       , Mm          , Gs^Fp       , Mm          , Mm          , Mm          
Hh          ,Hh          , Gs^Fp       , Ww          , Ww^Bw\      , Gs^Fp       , Gs^Fp       , Mm          , Mm^Xm       , Mm^Xm       , Mm          , Mm^Xm       , Mm^Xm       , Mm          , Gs^Fp       , Gs^Fp       , Ww^Bw/      , Ww          , Mm          , Gs^Fp       , Mm          , Gs^Fp       , Gs^Fp       , Hh          , Gs^Fp       , Gs^Fp       , Gs^Fp       , Mm^Vhh      , Gs^Fp       , Mm          , Gs^Fp       , Mm          , Mm          
Hh          ,Hh          , Gs^Fp       , Ww          , Ww          , Kh          , Gs^Fp       , Mm          , Gs^Fp       , Mm^Xm       , Mm          , Mm^Xm       , Gs^Fp       , Mm          , Gs^Fp       , Kh          , Ww          , Ww          , Mm          , Mm^Vhh      , Mm          , Gs^Fp       , Gs^Fp       , Gs^Fp       , Mm          , Gs^Fp       , Mm          , Gs^Fp       , Mm          , Mm          , Gs^Fp       , Gs^Fp       , Gs^Fp       
Hh          ,Hh          , Hh          , Hh          , Ww          , Ww^Bw|      , Ww^Bw\      , Gs^Fp       , Gs^Fp       , Mm          , Gs^Fp       , Mm          , Gs^Fp       , Gs^Fp       , Ww^Bw/      , Ww^Bw|      , Ww          , Mm          , Mm          , Mm          , Mm          , Mm          , Mm          , Gs^Fp       , Mm          , Mm          , Hh          , Mm          , Gs^Fp       , Mm          , Gs^Fp       , Gs^Fp       , Gs^Fp       
Mm          ,Mm          , Mm          , Mm          , Hh          , Ww          , Ww          , Kh          , Ww^Bw\      , Gs^Fp       , Kh          , Gs^Fp       , Ww^Bw/      , Kh          , Ww          , Ww          , Hh          , Hh          , Mm          , Gs^Fp       , Mm          , Mm^Vhh      , Mm          , Mm          , Gs^Fp       , Gs^Fp       , Hh          , Gs^Fp       , Gs^Fp       , Mm          , Gs^Fp       , Gs^Fp       , Gs^Fp       
Mm          ,Mm          , Mm          , Mm          , Hh          , Ww          , Ww          , Ww          , Ww          , Ww^Bw/      , Ww          , Ww^Bw\      , Ww          , Ww          , Ww          , Mm          , Hh          , Hh          , Gs^Fp       , Gs^Fp       , Mm          , Mm          , Gs^Fp       , Gs^Fp       , Mm          , Mm          , Mm          , Hh          , Gs^Fp       , Gs^Fp       , Gs^Fp       , Gs^Fp       , Gs^Fp       
Mm          ,Mm          , Gs^Fp       , Gs^Fp       , Gs^Fp       , Hh          , Mm          , Mm          , Mm          , Ww          , Gs^Fp       , Ww          , Ww          , Ww          , Hh          , Mm          , Mm          , Gs^Fp       , Mm          , Hh          , Hh          , Gs^Fp       , Mm          , Mm          , Gs^Fp       , Mm          , Gs^Fp       , Gs^Fp       , Gs^Fp       , Mm          , Mm          , Mm          , Mm          
Mm          ,Mm          , Mm          , Gs^Fp       , Hh          , Hh          , Gs^Fp       , Mm          , Mm^Vhh      , Mm          , Mm          , Gs^Fp       , Gs^Fp       , Gs^Fp       , Mm          , Hh          , Hh          , Mm          , Gs^Fp       , Mm          , Mm          , Hh          , Mm          , Mm          , Mm          , Mm^Vhh      , Mm          , Mm          , Gs^Fp       , Gs^Fp       , Gs^Fp       , Gs^Fp       , Gs^Fp       
Mm          ,Mm          , Gs^Fp       , Hh          , Hh          , Hh          , Gs^Fp       , Gs^Fp       , Mm          , Mm          , Gs^Fp       , Mm          , Hh          , Mm          , Mm          , Mm          , Gs^Fp       , Gs^Fp       , Gs^Fp       , Mm          , Mm          , Hh          , Gs^Fp       , Gs^Fp       , Hh          , Mm          , Hh          , Gs^Fp       , Mm          , Mm          , Gs^Fp       , Gs^Fp       , Gs^Fp       
Gs^Fp       ,Gs^Fp       , Gs^Fp       , Mm          , Mm          , Hh          , Mm          , Mm          , Mm          , Gs^Fp       , Gs^Fp       , Gs^Fp       , Gs^Fp       , Hh          , Mm          , Mm          , Mm          , Gs^Fp       , Mm          , Hh          , Mm          , Gs^Fp       , Mm          , Gs^Fp       , Gs^Fp       , Hh          , Hh          , Mm          , Mm          , Mm          , Gs^Fp       , Gs^Fp       , Gs^Fp       
Gs^Fp       ,Gs^Fp       , Gs^Fp       , Gs^Fp       , Gs^Fp       , Gs^Fp       , Gs^Fp       , Gs^Fp       , Mm          , Gs^Fp       , Gs^Fp       , Gs^Fp       , Gs^Fp       , Gs^Fp       , Mm          , Gs^Fp       , Gs^Fp       , Gs^Fp       , Mm          , Hh          , Hh          , Mm          , Gs^Fp       , Gs^Fp       , Mm          , Gs^Fp       , Gs^Fp       , Gs^Fp       , Mm          , Mm          , Gs^Fp       , Gs^Fp       , Gs^Fp       
Mm          ,Mm          , Gs^Fp       , Gs^Fp       , Mm          , Mm          , Gs^Fp       , Mm          , Mm          , Gs^Fp       , Hh          , Hh          , Hh          , Hh          , Mm          , Mm^Vhh      , Mm          , Gs^Fp       , Gs^Fp       , Mm          , Mm          , Mm          , Mm          , Mm          , Mm          , Mm          , Mm^Vhh      , Gs^Fp       , Gs^Fp       , Mm          , Gs^Fp       , Gs^Fp       , Gs^Fp       
Mm          ,Mm          , Mm          , Mm          , Mm          , Mm          , Mm          , Gs^Fp       , Mm          , Mm          , Hh          , Hh          , Hh          , Hh          , Gs^Fp       , Mm          , Mm          , Mm          , Gs^Fp       , Mm          , Mm          , Gs^Fp       , Mm          , Gs^Fp       , Mm          , Gs^Fp       , Gs^Fp       , Gs^Fp       , Gs^Fp       , Mm          , Mm          , Mm          , Mm          
Mm          ,Mm          , Mm          , Gs^Fp       , Mm          , Mm^Vhh      , Mm          , Mm          , Gs^Fp       , Gs^Fp       , Mm          , Mm          , Mm          , Gs^Fp       , Gs^Fp       , Gs^Fp       , Mm          , Mm          , Mm          , Mm          , Gs^Fp       , Gs^Fp       , Mm          , Mm          , Gs^Fp       , Mm          , Mm          , Mm          , Hh          , Mm          , Hh          , Hh          , Hh          
Mm          ,Mm          , Mm          , Gs^Fp       , Mm          , Hh          , Mm          , Gs^Fp       , Gs^Fp       , Mm          , Mm          , Gs^Fp       , Gs^Fp       , Mm          , Gs^Fp       , Mm          , Mm          , Gs^Fp       , Mm          , Gs^Fp       , Gs^Fp       , Mm^Vhh      , Mm          , Mm          , Gs^Fp       , Gs^Fp       , Mm^Vhh      , Gs^Fp       , Gs^Fp       , Hh          , Mm          , Mm          , Mm          
Mm          ,Mm          , Gs^Fp       , Gs^Fp       , Hh          , Hh          , Gs^Fp       , Mm          , Gs^Fp       , Hh          , Mm^Vhh      , Gs^Fp       , Gs^Fp       , Gs^Fp       , Mm          , Gs^Fp       , Hh          , Mm          , Gs^Fp       , Mm          , Mm          , Mm          , Mm          , Mm          , Mm          , Gs^Fp       , Mm          , Mm          , Hh          , Gs^Fp       , Mm          , Mm          , Mm          
Hh          ,Hh          , Hh          , Mm          , Mm          , Mm          , Mm          , Gs^Fp       , Hh          , Hh          , Hh          , Mm          , Ce          , Mm          , Mm          , Gs^Fp       , Hh          , Hh          , Gs^Fp       , Gs^Fp       , Gs^Fp       , Gs^Fp       , Gs^Fp       , Gs^Fp       , Gs^Fp       , Gs^Fp       , Mm          , Mm          , Hh          , Hh          , Hh          , Hh          , Hh          
Hh          ,Hh          , Gs^Fp       , Hh          , Hh          , Mm          , Mm          , Gs^Fp       , Gs^Fp       , Hh          , Mm          , Mm          , Ce          , Ce          , Ce          , Gs^Fp       , Mm          , Mm          , Mm          , Mm          , Mm          , Gs^Fp       , Mm          , Gs^Fp       , Gs^Fp       , Gs^Fp       , Mm          , Ce          , Ce          , Hh          , Mm          , Mm          , Mm          
Hh          ,Hh          , Gs^Fp       , Gs^Fp       , Gs^Fp       , Gs^Fp       , Gs^Fp       , Mm          , Mm          , Mm          , Gs^Fp       , Mm          , Mm          , Mm          , Ce          , Mm          , Mm          , Mm^Vhh      , Mm          , Gs^Fp       , Gs^Fp       , Mm          , Gs^Fp       , Gs^Fp       , Hh          , Mm          , Gs^Fp       , Ce          , Ce          , Ce          , Gs^Fp       , Gs^Fp       , Gs^Fp       
Hh          ,Hh          , Hh          , Gs^Fp       , Gs^Fp       , Gs^Fp       , Gs^Fp       , Mm          , Mm          , Gs^Fp       , Mm          , Gs^Fp       , Mm          , Ce          , Mm          , Mm          , Hh          , Hh          , Mm          , Gs^Fp       , Mm          , Mm          , Hh          , Hh          , Mm          , Mm          , Mm          , Mm          , Gs^Fp       , Ce          , Gs^Fp       , Gs^Fp       , Gs^Fp       
Mm          ,Mm          , Mm          , Hh          , Mm          , Gs^Fp       , Gs^Fp       , Gs^Fp       , Mm          , Mm          , Mm          , Mm          , Mm          , Mm          , Mm          , Mm          , Hh          , Hh          , Hh          , Mm          , Mm          , Mm          , Hh          , Hh          , Hh          , Mm          , Mm          , Mm          , Gs^Fp       , Gs^Fp       , Gs^Fp       , Gs^Fp       , Gs^Fp       
Mm          ,Mm          , Mm          , Hh          , Mm          , Gs^Fp       , Gs^Fp       , Gs^Fp       , Mm          , Mm          , Mm          , Mm          , Mm          , Mm          , Mm          , Mm          , Hh          , Hh          , Hh          , Mm          , Mm          , Mm          , Hh          , Hh          , Hh          , Mm          , Mm          , Mm          , Gs^Fp       , Gs^Fp       , Gs^Fp       , Gs^Fp       , Gs^Fp       
